aborterade_foster	neg
akta_sig	neg
akuta_tillstånd	neg
alarmerande_dåligt	neg
alarmerande_högt	neg
alarmerande_utveckling	neg
aldrig_i_helvete	neg
aldrig_i_livet	neg
aldrig_mer_i_mitt_liv	neg
allena_saliggörande	pos
allergiska_reaktioner	neg
all_time_high	pos
allvarliga_bieffekter	neg
allvarliga_brister	neg
allvarliga_effekter	neg
allvarliga_följder	neg
allvarliga_hälsorisker	neg
allvarliga_händelser	neg
allvarliga_infektioner	neg
allvarliga_komplikationer	neg
allvarliga_konsekvenser	neg
allvarliga_läget	neg
allvarliga_problem	neg
allvarliga_reaktioner	neg
allvarligare_bieffekter	neg
allvarligare_läge	neg
allvarligare_reaktioner	neg
allvarligare_rubbning	neg
allvarliga_risker	neg
allvarliga_riskfaktorer	neg
allvarliga_skador	neg
allvarliga_symptom	neg
allvarliga_symtom	neg
allvarliga_tillbud	neg
allvarliga_tillstånd	neg
allvarlig_biverkning	neg
allvarlig_brist	neg
allvarlig_försämring	neg
allvarlig_karaktär	neg
allvarlig_kris	neg
allvarlig_oro	neg
allvarlig_påverkan	neg
allvarlig_risk	neg
allvarlig_situationen	neg
allvarlig_situation	neg
allvarlig_störning	neg
allvarligt_brott	neg
allvarligt_läget	neg
allvarligt_problem	neg
allvarligt_sjukdomsförlopp	neg
allvarligt_smittläge	neg
allvarlig_utveckling	neg
ana_ugglor_i_mossen	neg
andra_klass	neg
andra_nivån	neg
ansluta_sig	pos
arta_sig	pos
autoimmuna_reaktioner	neg
autoimmuna_reaktion	neg
autoimmuna_sjukdomar	neg
autoimmuna_sjukdom	neg
autoimmune_disease	neg
autoimmun_reaktion	neg
autoimmun_sjukdom	neg
av_guds_nåde	pos
avgå_med_segern	pos
av_största_vikt	pos
avsäga_sig	neg
bad_news	neg
bad_om_ursäkt	pos
bakomliggande_hälsoproblem	neg
bakomliggande_sjukdomar	neg
bakomliggande_sjukdom	neg
bakomliggande_sjuklighet	neg
bakom_lås_och_bom	neg
banne_mig	neg
bedrövlig_nog	neg
be_förbehållslöst_om_ursäkt	pos
begränsad_kapacitet	neg
belasta_sjukvården	neg
be_om_förlåtelse	pos
be_om_ursäkt	pos
berg_och_dalbana	neg
ber_inte_om_ursäkt	neg
ber_jag_om_ursäkt	pos
ber_mycket_om_ursäkt	pos
ber_om_ursäkt	pos
ber_verkligen_om_ursäkt	pos
beskäftig_person	neg
besluta_sig	pos
besvära_sig	neg
betala_sig	pos
betona_för_mycket	neg
bett_folket_om_ursäkt	pos
bett_om_ursäkt	pos
betydligt_mer	pos
bevisad_effekt	pos
be_världen_om_ursäkt	pos
bister_uppsyn	neg
biter_i_det_sura_äpplet	neg
blanda_in	neg
blanda_sig_i	neg
blind_tilltro	neg
blint_lita	neg
bli_rik	neg
bli_över	pos
bluff_och_båg	neg
blåst_på_konfekten	neg
bortom_all_räddning	neg
bortse_från	neg
bortser_från	neg
bortses_från	neg
boven_i_dramat	neg
bra_budskap	pos
bra_effekt	pos
bra_förmåga	pos
bra_förutsättningar	pos
bra_gjord	pos
bra_grepp	pos
bra_grund	pos
bra_hanterat	pos
bra_idéer	pos
bra_ide	pos
bra_idé	pos
bra_jobbat	pos
brakade_loss	neg
bra_komplement	pos
bra_kontroll	pos
bra_liv	pos
bra_lösning	pos
bra_prestanda	pos
bra_resultat	pos
bra_rutiner	pos
bra_råd	pos
bra_samarbete	pos
bra_skarp	pos
bra_skydd	pos
bra_start	pos
bra_stöd	pos
bra_tryck	pos
bra_underlag	pos
bra_upplösning	pos
bra_utgångsläge	pos
bra_vaccin	pos
bra_åtgärd	pos
bristande_effektivitet	neg
bristande_förmåga	neg
bristande_förståelse	neg
bristande_hygienrutiner	neg
bristande_intelligens	neg
bristande_karaktär	neg
bristande_kompetens	neg
bristande_kunskaper	neg
bristande_källkritik	neg
bristande_läskunnighet	neg
bristande_prestanda	neg
bristande_rutiner	neg
bristande_säkerhet	neg
bristande_tankeförmåga	neg
bristande_transparens	neg
bristande_verklighetsuppfattning	neg
brist_på_sammanhang	neg
brott_mot_mänskligheten	neg
brusa_upp	neg
brutalt_dumma	neg
brutalt_dum	neg
brydde_mig	pos
brydde_sig	pos
bry_mig	pos
bryr_dig	pos
bryr_mig	pos
bryr_sig	pos
bry_sig	pos
bryta_ned	neg
bryta_ner	neg
bryter_mot	neg
bryter_ned	neg
bud_riggning	neg
bygga_ut	pos
bära_frukt	pos
bära_i_gullstol	pos
bära_sig	pos
bäst_presterande	pos
bättra_på	pos
bättra_sig	pos
bättre_förutsättningar	pos
bättre_koll	pos
bättre_läge	pos
bättre_möjligheter	pos
bättre_resultat	pos
bättre_rustade	pos
bättre_rustad	pos
bättre_rustat	pos
bättre_sammanhållning	pos
bättre_tillgång	pos
bättre_uppfattning	pos
bättre_villkor	pos
bättre_än_förväntat	pos
bättre_överblick	pos
bönade_och_bad	neg
böna_och_be	neg
coola_saker	pos
corona-krisens_spår	neg
covid_19	neg
covidsjuka_äldre	neg
covid_utrotas	pos
dela_med_sig	pos
det_är_där_skon_klämmer	neg
diaboliska_globalistplanen	neg
diaboliskt_plan	neg
direkt_felaktigt	neg
direkt_fel	neg
diska_av	pos
djupt_beklaga	neg
djupt_beklagligt	neg
djupt_tragiskt	neg
dold_agenda	neg
down_syndrom	neg
drabbades_extra_hårt	neg
drabbades_hårdare	neg
drabbas_allvarligare	neg
drabbas_extra_hårt	neg
drabbas_hårdare	neg
drabbas_hårdast	neg
drabbas_hårt	neg
drabbas_svårt	neg
drabbas_värst	neg
drabbats_hårdare	neg
drabbats_hårt	neg
dra_ett_streck	pos
dra_fram	neg
dra_in	neg
dramatiska_besked	neg
dramatiska_effekter	neg
dramatiska_känslor	neg
dramatiska_siffror	neg
dramatiska_utvecklingen	neg
dramatiskt_förlopp	neg
dramatiskt_sätt	neg
dramatisk_utveckling	neg
dra_nytta	pos
dra_på_smilbanden	pos
drar_fram	neg
drar_upp	pos
drar_ut_på_tiden	pos
drastiskt_förändrad	neg
dra_tillbaka	neg
dra_upp	pos
dra_ut_på_tiden	pos
dra_åt_helvete	neg
drog_sig_tillbaka	neg
duktiga_idioter	neg
dum_i_huvudet	neg
dumma_huvudet	neg
dumma_nog	neg
dyrbart_fiasko	neg
dyster_bild	neg
dyster_milstolpe	neg
dyster_rekordsiffra	neg
dystert_dagsrekord	neg
dystert_dygnsrekord	neg
dyster_toppnotering	neg
dystert_rekord	neg
dyster_trend	neg
dystert_virusläge	neg
dystert_virusrekord	neg
dystert_världsrekord	neg
dyster_vår	neg
dystra_beskedet	neg
dystra_besked	neg
dystra_coronarekord	neg
dystra_coronasiffror	neg
dystra_dygnsrekord	neg
dystra_facit	neg
dystra_milstolpar	neg
dystra_milstolpen	neg
dystra_prognosen	neg
dystra_rekordet	neg
dystra_rekordsiffror	neg
dystra_siffrorna	neg
dystra_siffror	neg
dystra_tider	neg
dystra_till	neg
dystra_världsrekord	neg
dåliga_levnadsvanor	neg
dålig_användning	neg
dålig_effektivitet	neg
dålig_hjälp	neg
dålig_hälsa	neg
dålig_immunitet	neg
dålig_kvalitet	neg
dålig_prognos	neg
dålig_psykisk_hälsa	neg
dålig_självkänsla	neg
dålig_strategi	neg
dåligt_använda	neg
dåligt_bemötande	neg
dålig_tillgång	neg
dåligt_immunförsvar	neg
dåligt_omdöme	neg
dåligt_rustade	neg
dåligt_rykte	neg
dåligt_råd	neg
dåligt_samvete	neg
dåligt_skydd	neg
dåligt_skämt	neg
dåligt_sorterad	neg
dåligt_tecken	neg
dåligt_utformad	neg
dålig_utgångspunkt	neg
dålig_utsikt	neg
dålig_överblick	neg
dämpande_effekt	pos
dödliga_giftet	neg
dödliga_våldet	neg
dödlig_sjukdom	neg
dödssprutan	neg
dö_som_flugor	neg
effektivare_stridsmedel	neg
effektivt_skydd	pos
egoistisk_prägel	neg
ekonomiska_klyftorna	neg
ekonomiska_marginaler	pos
ekonomisk_nedgång	neg
ekonomiskt_stöd	pos
elitistisk_skara	neg
empatilösa_svin	neg
energi_sparande	pos
en_gång_i_livet	pos
en_het_potatis	neg
enorm_vrede	neg
ensamma_äldre	neg
erbarmeliga_tystnadskultur	neg
etiska_dilemman	neg
etter_värre	neg
extra_hårt	neg
extra_noga	pos
extrema_åsikter	neg
extrem_fattigdom	neg
extrem_fetma	neg
extrem_påfrestning	neg
extrem_risk	neg
extrem_situation	neg
extremt_allvarliga	neg
extremt_allvarlig	neg
extremt_allvarligt	neg
extremt_behov	neg
extremt_bra	pos
extremt_noga	pos
extremt_sköra	neg
extremt_svår	neg
extremt_svårt	neg
extremt_tydliga	pos
fake_news	neg
falla_in	pos
falla_samman	pos
falla_sönder	neg
faller_ihop	neg
faller_sönder	neg
faller_trovärdigheten	neg
falska_nyheter	neg
falska_positiva	neg
falska_positiv	neg
falsk_marknadsföring	neg
falsk_positiv	neg
falskt_negativa	neg
falskt_negativt	neg
falskt_positiva	neg
falskt_positiv	neg
falskt_positivt	neg
falsk_trygghet	neg
fanskaps_kvackare	neg
fantastisk_milstolpe	pos
fantastiskt_bra	pos
fantastiskt_roligt	pos
farligt_nog	neg
fast_besluten	pos
fastnade_i_musfällan	neg
fatta_beslut	pos
felakrig_demokrati	neg
fel_sort	neg
fel_tillfälle	neg
feta_arvoden	neg
feta_katter	neg
fet_katt	neg
fet_skandal	neg
fick_nog	neg
fiffa_opp	pos
fiffa_upp	pos
fina_fisken	pos
finaste_sort	pos
finnas_i_överflöd	pos
fin_sammanhållning	pos
fixade_fram	pos
fjärde_statsmakten	neg
f_**_k	neg
flippar_ur	neg
flippa_ur	neg
fortsatt_bra	pos
frigöra_resurser	pos
frigör_resurser	pos
friska_upp	pos
friskna_till	pos
frivilliga_aborter	neg
frivilliga_restriktioner	neg
frivillig_distansering	neg
frivillig_ensamhet	neg
frivillig_hemkarantän	neg
frivillig_isolering	neg
frivillig_karantän	neg
frivillig_lockdown	neg
frivillig_självisolering	neg
fruktansvärda_nyheter	neg
fruktansvärd_utveckling	pos
fruktansvärt_bra	pos
fruktansvärt_ensam	neg
fruktansvärt_jobbigt	neg
frysa_ut	neg
fucking_mongos	neg
fulla_kraft	neg
full_aktivitet	pos
full_av_liv	pos
full_bra	pos
full_frisk	pos
full_förståeligt	pos
full_förståelse	pos
full_koll	pos
fullkomlig_panik	neg
fullkomligt_irrelevant	neg
fullkomligt_vanvett	neg
fullkomligt_vettlöst	neg
full_kunskap	pos
full_panik	neg
full_respekt	pos
full_rättighet	pos
full_säkerhet	pos
fullt_beredvilliga	pos
fullt_friska	pos
fullt_frisk	pos
fullt_fungerande	pos
fullt_förståeligt	pos
fullt_förtroende	pos
fullt_förväntat	pos
fullt_krig	neg
fullt_logisk	pos
fullt_med_folk	neg
fullt_möjligt	pos
fullt_naturligt	pos
fullt_normalt	pos
full_transparens	pos
fullt_rationella	pos
fullt_rationell	pos
fullt_rimliga	pos
fullt_rimligt	pos
fullt_skydd	pos
fullt_stöd_från	pos
fullt_trygg	pos
fullt_vaccinerade	pos
fullt_vaccinerad	pos
fullt_återöppnande	pos
full_valfrihet	pos
fundamentalistiska_sekter	neg
fundamentalistiska_tro	neg
fungera_bra	pos
fungerar_dåligt	neg
fungerar_ej	neg
fungerar_inte	neg
fy_dig	neg
fy_fan	neg
fy_f*n	neg
fy_katten	neg
fyrkantiga_västlänningar	neg
fysiska_aktiviteter	pos
fysisk_aktivitet	pos
fysiska_våldet	neg
fysisk_distansering	neg
fysisk_distans	neg
fysisk_stress	neg
fysiskt_aktiva	pos
fysiskt_ont	neg
fysisk_träning	pos
fysiskt_sårbara	neg
fysiskt_våld	neg
fy_skam	neg
fy_vad_jobbigt	neg
får_panik	neg
fått_nog	neg
föga_övertygande	neg
följa_upp	pos
följer_upp	pos
förbättrad_situation	pos
fördjupar_sig	pos
fördjupa_sig	pos
för_dyrt	neg
förebyggande_arbete	pos
förebyggande_arbetet	pos
förebyggande_effekt	pos
förebyggande_insatser	pos
förebyggande_skydd	pos
förebyggande_åtgärderna	pos
förebyggande_åtgärder	pos
förebyggande_åtgärd	pos
förespråkade_våld	neg
förespråkar_våld	neg
förespråka_våld	neg
för_f*n	neg
förhindrad_spridning	pos
förhindra_spridningen	pos
förhindra_spridning	pos
förhöjd_risk	neg
förkovrar_sig	pos
förkovra_sig	pos
förlorad_inkomst	neg
förlora_jobbet	neg
förlova_sig	pos
förringa_behovet	neg
första_klass	pos
förställa_sig	neg
försvagade_immunförsvar	neg
försvagade_immunsystemet	neg
försvagade_virus	pos
försvagat_immunförsvar	neg
försvagat_immunsystem	neg
försvagat_virus	pos
försämrad_ekonomi	neg
galet_härligt	pos
galna_kosjukan	neg
gammal_nog	neg
ganska_tungt	neg
gasa_ihjäl	neg
gasar_ihjäl	neg
gav_upp	neg
ge_efter	neg
ge_fan_i	neg
ge_igen	neg
gemene_man	neg
generösa_villkor	pos
genetiska_förändringar	neg
genmanipulation	neg
ger_tillbaka	pos
ger_upp	neg
ge_sig_av	pos
ge_sig	pos
ge_sig_på	neg
ge_tillbaka	pos
gett_upp	neg
ge_upp	neg
gick_illa	neg
gick_in_i_väggen	neg
gick_på_knäna	neg
gillar_inte	neg
gjort_starkast_intryck	pos
gjort_större_intryck	pos
gjuta_olja_på_elden	neg
glada_nyheter	pos
gladeligen_döda	neg
glatt_litet	neg
glimten_i_ögat	pos
globala_uppvärmningen	neg
globaliserad_värld	neg
globalisternas_nya_matrix	neg
glädde_sig	pos
gläder_sig	pos
glädja_sig	pos
glädjer_sig	pos
glömskans_dy	neg
gnissla_med_tänderna	neg
goda_chanser	pos
goda_effekten	pos
goda_förhoppningar	pos
goda_förutsättningar	pos
goda_möjligheter	pos
goda_nyheter	pos
goda_resultaten	pos
goda_resultat	pos
goda_rutiner	pos
goda_råd	pos
goda_utsikter	pos
goda_vanor	pos
god_effekt	pos
god_grund	pos
god_hjälp	pos
god_hälsa	pos
god_kapacitet	pos
god_kontroll	pos
god_kvalitet	pos
god_marginal	pos
god_nyhet	pos
god_omvårdnad	pos
god_prognos	pos
god_sammanhållning	pos
god_skyddseffekt	pos
god_uppfattning	pos
god_vård	pos
gott_och_väl	pos
grav_fetma	neg
great_reset	neg
gripa_sig_an	pos
grov_förbrytelse	neg
grovt_brott	neg
grovt_smicker	pos
grovt_våld	neg
grymt_bra	pos
gråta_floder	neg
grönt_ljus	pos
grön_tvätt	neg
gudi_behaglig	pos
gula_febern	neg
gå_bra	pos
gå_hem	pos
gå_i_bitar	neg
gå_ihop	pos
gå_i_land	pos
gå_illa	neg
gå_i_lås	pos
gå_in	pos
gå_i_pension	pos
gå_i	pos
gå_långt	pos
gå_ned_sig	neg
går_i_bitar	neg
går_i_pension	pos
går_i_taket	neg
går_på_knäna	neg
går_utför	neg
går_vidare	pos
gå_sönder	neg
gå_till_spillo	neg
gått_bort	neg
gå_upp_i_limningen	neg
gå_utför	neg
gå_ut	pos
gå_vidare	pos
gå_vägen	pos
gå_över_ån_efter_vatten	neg
gömde_sig	neg
gömmer_sig	neg
göra_gott	pos
göra_intryck	pos
göra_livet_surt	neg
göra_rasande	neg
göra_rätt_för_sig	pos
göra_sig	pos
göra_skäl	pos
göra_stan	pos
göra_upp_räkningen	neg
gör_intryck	pos
habilitera_sig	pos
ha_en_gås_oplockad	neg
halka_efter	neg
halka_ner	neg
halkar_efter	neg
halkar_ner	neg
halkat_efter	neg
halkat_ner	neg
happy_ending	pos
happy_endings	pos
harmas_över	neg
ha_rätt	pos
ha_sönder	neg
hatar_att_leva	neg
hedersrelaterat_våld	neg
heja_på	pos
helt_klart	pos
helt_lost	neg
helt_ny	pos
helt_rätt	pos
hemligt_ondskefullt	neg
hemsk_biverkning	neg
herre_gud	neg
herren_gud	pos
het_potatis	neg
hetsats_fram	neg
hetsa_upp	neg
himla_go	pos
himla_så_smart	pos
hipp_som_happ	neg
hjälpa_till	pos
hjälper_till	pos
hokus_pokus	neg
hoppa_av	neg
hoppa_hage	pos
hoppa_rep	pos
hyra_in	pos
hyrde_in	pos
hålla_i_gång	pos
hålla_ihop	pos
hålla_kontakten	pos
hålla_kontakt	pos
hålla_käften	neg
hålla_käft	neg
hålla_med	pos
hålla_måttet	pos
hålla_på	pos
hålla_sams	pos
hålla_sig_isolerad	neg
hålla_sig	pos
hålla_streck	pos
hålla_till_godo	pos
hålla_ut	pos
håller_ihop	pos
håller_inte_med	neg
håller_käften	neg
håller_käft	neg
håller_med	pos
håller_måttet	pos
håll_käften	neg
håll_käft	neg
hårda_krav	neg
hårda_pressen	neg
hårdare_coronarestriktioner	neg
hårdare_krav	neg
hårdare_nedstängning	neg
hårdare_regler	neg
hårdare_reserestriktioner	neg
hårdare_restriktionerna	neg
hårdare_tag	neg
hårdare_åtgärder	neg
hård_press	neg
hård_träff	neg
hårresande_beslut	neg
hårt_arbetande	pos
hårt_drabbade	neg
hårt_pressad	neg
hårt_sargade	neg
hårt_slag	neg
håva_in	pos
hämmande_effekt	pos
hänga_läpp	neg
hänga_med_huvudet	neg
hänga_på_en_skör_tråd	neg
hänga_sig	neg
hänga_ut	neg
hänger_läpp	neg
hänger_med_huvudet	neg
hänger_sig	neg
hög_arbetsbelastning	neg
höga_smittotal	neg
hög_belastning	neg
hög_dödlighet	neg
hög_effektivitet	pos
hög_frånvaro	neg
hög_kapacitet	pos
hög_kompetens	pos
hög_kvalitet	pos
hög_potential	pos
hög_prestanda	pos
hög_puls	neg
högre_risk	neg
hög_risk	neg
hög_sjukfrånvaro	neg
hög_skyddseffekt	pos
hög_smittorisk	neg
hög_smittrisk	neg
hög_smittsamhet	neg
hög_smittspridning	neg
högsta_grad	pos
högt_blodtryck	neg
högt_förtroende	pos
hög_tilltro	pos
högt_mörkertal	neg
högt_oroande	neg
högt_pris	neg
högt_skydd	pos
högt_tonläge	neg
högt_värde	pos
hög_överdödlighet	neg
höja_till_skyarna	pos
höjer_till_skyarna	pos
höll_med	pos
höll_måttet	pos
höna_av_en_fjäder	neg
i_aktionen	pos
i_aktion	pos
i_balansen	pos
i_balans	pos
icke_godkänd	neg
icke_oäven	pos
idiotiskt_nog	neg
i_en_klass_för_sig	pos
i_förtvivlan	neg
i_godo	pos
i_god_tid	pos
illa_behandlad	neg
illa_bemött	neg
illa_definierade	neg
illa_däran	neg
illa_formad	neg
illa_rustade	neg
illa_rustad	neg
illa_till_mods	neg
illa_tänkt	neg
illa_uppfört	neg
infantila_rapporteringar	neg
infantil_retorik	neg
inge_mod	pos
inget_hopp	neg
injicera_ihjäl	neg
injicerar_ihjäl	neg
inlägga_förtjänst	pos
instämde_inte	neg
instämmer_inte_alls	neg
inte_acceptabelt	neg
inte_allvarligt	pos
inte_bad_om_ursäkt	neg
inte_be_om_ursäkt	neg
inte_ber_jag_om_ursäkt	neg
inte_ber_om_ursäkt	neg
inte_bevisar	neg
inte_bevisat	neg
inte_en_chans	neg
inte_ensamt	pos
inte_farligare	pos
inte_fullt	pos
inte_fungerar	neg
inte_förvånad	neg
inte_förvånande	neg
inte_godkänna	neg
inte_godkänt	neg
inte_håller_med	neg
inte_imponerad	neg
inte_lyda	neg
inte_möjligt	neg
inte_omöjligt	pos
inte_rekommenderas	neg
inte_rekommenderats	neg
inte_rädda	pos
inte_självklart	neg
inte_säker	neg
inte_säkra	neg
inte_tillgänglig	neg
inte_tillräckliga	neg
inte_tillräcklig	neg
inte_tillräckligt	neg
intet_ont_anande	neg
inte_tro	neg
inte_utvecklat	neg
inte_övertygad	neg
i_olag	neg
ironiskt_nog	neg
i_sjunde_himlen	pos
i_strykklass	neg
i_överflöd	pos
jesus_kristus	pos
jobba_hårt	pos
jobbat_hårt	pos
jobbigt_läge	neg
jäkligt_bra	pos
jäkligt_glada	pos
jäkligt_skönt	pos
jämna_vägen	pos
jämra_sig	neg
jävla_ansikte	neg
jävla_beslutsångest	neg
jävla_blåsta_människor	neg
jävla_blåögd	neg
jävla_bra	pos
jävla_dumheter	neg
jävla_dumma	neg
jävla_dåre	neg
jävla_engagerad	pos
jävla_enkelt	pos
jävla_goda	pos
jävla_groteskt	neg
jävla_hjälte	pos
jävla_hjärntvättad	neg
jävla_huvud	neg
jävla_idiot	neg
jävla_jackpot	pos
jävla_kärringar	neg
jävla_kärring	neg
jävla_landet	neg
jävla_less	neg
jävla_loser	neg
jävla_luffare	neg
jävla_lättlurad	neg
jävla_nolla	neg
jävla_passande	pos
jävla_politiker	neg
jävla_roliga	pos
jävla_sjuk	neg
jävla_skit	neg
jävla_skitsnack	neg
jävla_stress	neg
jävla_säker	pos
jävla_tjat	neg
jävla_trams	neg
jävla_troll	neg
jävla_trötta	neg
jävla_trött	neg
jävla_tur	pos
jävla_tydligt	pos
jävla_underbart	pos
jävla_utvecklingsstört	neg
jävla_vaccin	neg
jävla_viktigt	pos
jävla_virus	neg
jävla_ångest	neg
jävla_åsikter	neg
jävla_överdrift	neg
jävligt_bra	pos
jävligt_dumt	neg
jävligt_glada	pos
jävligt_lätt	pos
kalla_kårar	neg
kan_erhållas	pos
kan_nås	pos
kan_uppgraderas	pos
kasta_bort	neg
kastade_bort	neg
kastas_överbord	neg
kasta_ut_barnet_med_badvattnet	neg
katastrofala_situationen	neg
kikna_av_skratt	pos
kiknar_av_skratt	pos
klara_bevis	pos
klarar_sig	pos
klara_sig	pos
klema_bort	pos
klent_utrustad	neg
klumpen_i_magen	neg
knipa_käft	neg
knip_käft	neg
knäppa_av	pos
knäppa_på	pos
koka_upp	neg
komma_hem	pos
komma_sig	pos
komma_till_pass	pos
komma_till_sin_rätt	pos
komma_åt	neg
komma_överens	pos
kommer_hem	pos
kommer_sig	pos
kommer_till_sin_rätt	pos
kommer_överens	pos
kommit_överens	pos
kom_överens	pos
koncentrerar_sig	neg
konstigt_nog	neg
kortsiktig_lösning	neg
kraftfulla_åtgärderna	pos
kraftfulla_åtgärder	pos
kraftfullt_ifrågasatt	neg
kraftfullt_misskött	neg
kraftfull_åtgärd	pos
kramar_sig	neg
kritiska_kommentarer	pos
kritiska_synpunkter	pos
kritiska_åsikter	pos
kritisk_punkt	neg
kritisk_situation	neg
kritiskt_läge	neg
kritiskt_skede	neg
kritiskt_tillstånd	neg
kritiskt_tänkande	pos
kritisk_tänkande	pos
kroniska_sjukdomar	neg
kronisk_lungsjukdom	neg
kronisk_sjuka	neg
kroppsfrämmande_ämnen	neg
kroppsliga_ingrepp	neg
kryade_på_sig	pos
krya_på_sig	pos
krypa_till_korset	neg
kryper_till_korset	neg
kvicknar_till	pos
kvickna_till	pos
känna_empati	pos
känner_mig_sviken	neg
känner_sig_sviken	neg
känner_sig_så_svikna	neg
känns_lite_sådär	neg
känns_sådär	neg
käppar_i_hjulet	neg
kära_lilla_du	neg
köra_om	pos
lallar_omkring	neg
legat_nere	neg
le_i_mjugg	pos
ler_i_mjugg	pos
leva_upp	pos
leva_ut	pos
lever_upp	pos
lever_ut	pos
lidande_person	neg
ligga_lågt	pos
ligger_risigt_till	neg
lik_förbannat	neg
lita_blint	neg
litar_blint	neg
litar_på	pos
lite_feber	pos
lite_för_styrda	neg
lite_kunskap	neg
liten_chans	neg
liten_risk	pos
lite_resurser	neg
lite_skum	neg
litet_bekymmer	pos
litet_glädjebesked	pos
litet_glädjeämne	pos
lite_underlag	neg
lite_väl_mycket	neg
lite_värk	pos
liva_upp	pos
liv_skördades	neg
ljusa_upp	pos
ljuset_i_mörkret	pos
locka_till_sig	pos
lorta_ner	neg
lost_i_skallen	neg
lugna_ner_sig	pos
lura_sig	neg
lyckades_lura	neg
lyckades_utrota	pos
lyckas_lura	neg
lyckas_utrota	pos
lyckas_vända	pos
lycka_till	pos
lyckats_lura	neg
lyckats_undvika	pos
lyckats_utrota	pos
lycka_utrota	pos
lycklig_lottad	pos
lyckligt_lottade	pos
lyckligt_lottad	pos
lyfta_sig	pos
lysa_skarpt	neg
lysa_upp	pos
lyser_upp	pos
låg_dödlighet	neg
låg_dödlighet	pos
låg_funktionsförmåga	neg
låg_intelligens	neg
låg_kostnad	pos
låg_motivation	neg
låg_risk	pos
lågt_medvetande	neg
lågt_pris	pos
långdragna_besvär	neg
långsiktiga_bieffekter	neg
långsiktiga_biverkningarna	neg
långsiktiga_biverkningar	neg
långsiktiga_konsekvenserna	neg
långsiktiga_konsekvenser	neg
långsiktiga_problem	neg
långsiktig_bieffekter	neg
långsiktig_biverkning	neg
långsiktig_negativ	neg
lång_tid	neg
långvariga_besvär	neg
långvariga_hälsoproblem	neg
långvarig_biverkning	neg
långvarig_forskning	pos
långvarigt_skydd	pos
låta_nåd_gå_före_rätt	pos
låta_sig_nöja	pos
låta_udda_vara_jämnt	pos
låta_udda_vara_jämt	pos
låter_sig_nöja	pos
låter_sådär	neg
läcka_ut	neg
läcker_ut	neg
lägre_dödlighet	pos
lämplig_källa	pos
läsa_in	pos
läser_in	pos
läskigt_bra	pos
lätt_att_använda	pos
lätt_att_bli_andfådd	neg
lätt_att_glömma	neg
lätt_att_lura	neg
lätt_att_missa	neg
lätt_att_misslyckas	neg
lätt_för_att_gråta	neg
lätt_som_en_plätt	pos
läxa_upp	neg
löjla_sig	pos
löna_sig	pos
lösa_grunder	neg
lösa_in	pos
lösryckta_fakta	neg
löst_in	pos
mark_of_the_beast	neg
massa_skit	neg
med_armarna_i_kors	neg
med_eftertryck	neg
medelmåttig_intelligens	neg
med_fördel	pos
med_hull_och_hår	neg
medicinsk_bedömning	pos
medicinsk_bomb	pos
med_nöd_och_näppe	neg
med_respekt	pos
med_rätta	pos
med_vinst	pos
med_öppna_armar	pos
men_för_livet	neg
meningslösa_dravel	neg
mental_förnedring	neg
mental_ohälsa	neg
mentalt_kuvade	neg
mental_ångest	neg
milda_symptom	pos
milda_symtom	pos
mindre_allvarliga_konsekvenser	pos
mindre_allvarliga	pos
mindre_allvarligt	pos
mindre_begåvade	neg
mindre_betydelse	neg
mindre_biverkning	neg
mindre_chans	neg
mindre_drabbad	pos
mindre_dödliga	pos
mindre_dödlighet	pos
mindre_dödligt	pos
mindre_effektiva	neg
mindre_effektivt	neg
mindre_farlig	pos
mindre_farligt	pos
mindre_fördelaktigt	neg
mindre_lyckad	neg
mindre_mottaglig	neg
mindre_nogräknat	pos
mindre_omöjligt	pos
mindre_oroligheter	pos
mindre_paria	pos
mindre_pinsamt	pos
mindre_positiva	neg
mindre_påtvinga	pos
mindre_risk	pos
mindre_sjuk	pos
mindre_smittad	pos
mindre_smittsam	pos
mindre_smittspridning	pos
mindre_snömos	pos
mindre_trött	pos
mindre_tvingade	pos
mindre_tvingat	pos
mindre_tvungen	pos
mindre_tvång	pos
mindre_verkningslösa	pos
mindre_vetenskapligt	neg
mindre_värda	neg
mindre_värd	neg
mindre_värt	neg
mindre_äckligt	pos
mindre_överraskning	pos
minimala_fuskmöjligheter	neg
minimal_ansträngning	pos
minimal_belastning	pos
minimal_förbättring	neg
minimal_försämring	neg
minimal_påverkan	pos
minimal_risk	pos
minimalt_invasiv	neg
minimalt_skydd	neg
minimal_överdödlighet	neg
minska_intaget	pos
minska_miljöpåverkan	pos
minskar_föroreningar	pos
minska_risken	pos
minska_risk	pos
minska_smittspridningen	pos
minska_smittspridning	pos
minska_symptomen	pos
minska_symptom	pos
minska_symtomen	pos
minska_symtom	pos
minskat_barnafödande	neg
misstänkt_biverkning	neg
mitt_i_prick	pos
mitt_i_smeten	pos
mjölkas_pengar	neg
monetära_systemet	neg
moppsa_upp	neg
moraliskt_fel	neg
moraliskt_förkastlig	neg
mot_min_vilja	neg
mot_sin_vilja	neg
multisjuka_äldre	neg
muntra_opp	pos
muntra_upp	pos
mycket_bra	pos
mycket_dåligt	neg
mycket_farligt	neg
mycket_frikostigt	pos
mycket_god	pos
mycket_intryck	pos
mycket_liten	neg
mycket_liten_risk	pos
mycket_lång_tid	neg
mycket_nytta	pos
mycket_nyttigt	pos
mycket_oroliga	neg
mycket_sjuka	neg
mycket_sjukare	neg
mycket_sjuk	neg
mycket_sköra	neg
mycket_större_risk	neg
mycket_tragiskt	neg
mycket_tungt	neg
måla_fan_på_väggen	neg
må_som_en_prins	pos
märkligt_nog	neg
märkt_av_döden	neg
möjlig_biverkning	neg
möjligt_konstigt	neg
mörkare_krafter	neg
mörkare_motiv	neg
mörk_i_sinnet	neg
naggande_god	pos
naggande_gott	pos
naiv_korkad	neg
naturlig_immunitet	pos
naturlig_infektion	neg
nedlåta_sig	neg
nedsatt_hälsa	neg
negativa_effekterna	neg
negativa_effekter	neg
negativa_konsekvenserna	neg
negativa_konsekvenser	neg
negativa_långtidseffekter	neg
negativa_testresultat	pos
negativa_vibbar	neg
negativ_effekt	neg
negativ_klang	neg
negativ_syn	neg
negativt_antikroppstest	pos
negativt_corona	pos
negativt_coronatest	pos
negativt_corona-testresultat	pos
negativt_covid-19	pos
negativt_covid-19-prov	pos
negativt_covid-19-test	pos
negativt_covid	pos
negativt_covid-prov	pos
negativt_covid-test	pos
negativt_covidtest	pos
negativt_pcr-resultat	pos
negativt_pcr-svar	pos
negativt_pcr-test	pos
negativt_pcr-virustest	pos
negativt_provsvar	pos
negativt_rekord	neg
negativt_testresultat	pos
negativt_virustest	pos
nej_tack	neg
nemas_problemas	pos
new_world_order	neg
njuta_av	pos
njut_av	pos
njuter_av	pos
nog_bra	pos
nog_bäst	pos
nog_möjligt	pos
noll_bekymmer	pos
noll_förtroende	neg
nya_biverkningarna	neg
nya_biverkningar	neg
nya_blåmärken	neg
nya_cancerfall	neg
nya_covid-varianter	pos
nya_digerdöden	neg
nya_dödsfall	neg
nya_ideal	pos
nya_influensavaccinet	pos
nya_kunskapen	pos
nya_läkemedel	pos
nya_mediciner	pos
nya_mutationen	neg
nya_mutationerna	neg
nya_mutationer	neg
nya_mutation	neg
nya_muterade	neg
nya_preparat	pos
nya_problem	neg
nya_restriktioner	neg
nya_risker	pos
nya_rön	pos
nya_sjukdomar	neg
nya_skitsamhälle	neg
nya_superspridarna	pos
nya_tramset	pos
nya_trassel	neg
nya_vaccinerna	pos
nya_vacciner	pos
nya_viruset	neg
nya_virusmutationer	neg
nya_virus	neg
nya_virusstammar	pos
nya_virusutbrott	neg
nya_virusvarianterna	pos
nya_virusvarianter	neg
nya_världsordningen	neg
nya_världsordning	neg
ny_bedrägerivåg	neg
ny_biverkning	neg
ny_dubbelmutation	neg
ny_fascistisk	neg
ny_forskning	pos
ny_kunskap	pos
ny_mutation	neg
ny_nedstängning	neg
ny_teknologi	pos
nyttig_läxa	pos
nytt_oprövat	neg
nytt_virus	neg
ny_utbrott	neg
ny_virusmutation	neg
ny_virusstam	neg
ny_virusvariant	neg
nära_bristningsgränsen	neg
nära_kollaps	neg
nära_och_kära	pos
nära_samarbete	pos
nära_samverkan	pos
nära_varandra	pos
nöja_sig	pos
obefintlig_risk	pos
obelagda_fantasier	neg
obetydliga_besvär	pos
obetydliga_symptom	pos
obildbara_antivaxxers	neg
oerhört_ansträngt	neg
oerhört_beroende	neg
oerhört_hårt	neg
oerhört_lång_tid	neg
oerhört_lättad	pos
oerhört_rabiat	neg
oerhört_resurskrävande	neg
oerhört_svåra	neg
oerhört_svår	neg
oerhört_svårt	neg
oerhört_värde	pos
ofarlig_sjukdom	pos
ofarligt_virus	neg
ofattbart_idiotiskt	neg
oförmåga_att_förstå	neg
oförskämt_lätt	pos
ogift_kvinna	neg
ohälsosamma_levnadsvanor	neg
ojust_spel	neg
ok_källa	pos
olycklig_kärlek	neg
olyckligt_nog	neg
omfattande_konsekvenser	neg
omfattande_nedstängningar	neg
omfattande_nedstängning	neg
omfattande_restriktioner	neg
omfattande_samhällsspridningen	neg
omfattande_samhällsspridning	neg
omfattande_skador	neg
omfattande_smitta	neg
omfattande_smittspridningen	neg
omfattande_smittspridning	neg
omfattande_spridningen	neg
omfattande_spridning	neg
omfattande_stängning	neg
omfattande_underrapportering	neg
omöjlig_att_skilja	neg
omöjlig_att_stoppa	neg
omöjlig_att_stoppa	pos
onda_krafter	neg
ond_cirkel	neg
onyttigt_skräp	neg
operera_in	pos
orimliga_anställningsvillkor	neg
orimliga_arbetsvillkor	neg
orimliga_dödssiffror	neg
orimliga_förhållanden	neg
orimliga_rädsla	neg
orimligt_dyra	neg
orimligt_långa_väntetider	neg
orimligt_lång_tid	neg
oroväckande_nog	neg
oroväckande_resultat	neg
osäker_grund	neg
otroligt_sargat	neg
otrygg_grund	neg
oturligt_nog	neg
otydliga_direktiv	neg
ovanlig_biverkning	neg
ovanligt_bra	pos
ovanligt_känslotyngt	neg
ovetenskapliga_föreställningar	neg
pappa_staten	neg
paradoxalt_nog	neg
passa_ihop	pos
passa_in	pos
passa_samman	pos
pengar_tillbaka	pos
personlig_vinning	pos
pigga_opp	pos
pigga_upp	pos
piggnar_till	pos
piggna_till	pos
pirret_i_magen	pos
pirr_i_magen	pos
piska_upp	neg
platta_ut	neg
plocka_fram	pos
plockar_fram	pos
plågsamt_naiv	neg
plågsamt_sätt	neg
politisk_bluff	neg
politiskt_korrekt	pos
politiskt_självmord	neg
politiskt_våld	neg
poppar_champagne	pos
positiva_effekterna	pos
positiva_effekter	pos
positiva_tecken	pos
positiv_effekt	pos
pressad_sjukvård	neg
pressa_ut	neg
problem_i_äldreomsorgen	neg
psykisk_kolaps	neg
psykisk_ohälsa	neg
psykisk_sjukdom	neg
på_avstånd	neg
på_bättringsväg	pos
på_hal_is	neg
pålitlig_källa	pos
på_nytt_bekräfta	pos
på_tomgång	neg
på_topp	pos
ramlade_ihop	neg
ramla_ut	neg
rasande_fart	pos
reda_ut	neg
redigt_ont	neg
rejäl_smäll	neg
rejäl_spridning	neg
relativt_bra	pos
rena_döden	neg
rena_giftet	neg
ren_bacillskräck	neg
ren_bluff	neg
ren_desinformation	neg
ren_desinformationskampanj	neg
ren_diktatur	neg
ren_dumhet	neg
ren_egoist	neg
ren_fattigdom	neg
ren_foliehatt-mentalitet	neg
ren_galenskap	neg
ren_idioti	neg
ren_idiot	neg
ren_illvilja	neg
ren_ilska	neg
ren_jävla	neg
ren_katastrof	neg
ren_krigshandling	neg
ren_kriminalitet	neg
ren_lögn	neg
ren_misär	neg
ren_motvilja	neg
ren_nazism	neg
ren_nervgift	neg
ren_nonsens	neg
ren_omöjlighet	neg
ren_ondska	neg
ren_panik	neg
ren_paranoia	neg
ren_propaganda	neg
ren_skam	neg
ren_skit	neg
ren_skrämsel	neg
ren_skrämselpropaganda	neg
ren_smörja	neg
ren_spekulation	neg
rent_av_deprimerad	neg
rent_av_falska	neg
rent_av_farligt	neg
rent_blåljug	neg
rent_djävulskt	neg
rent_egoistiska	neg
rent_faktafel	neg
rent_felaktig	neg
rent_hjärnspöke	neg
rent_hyckleri	neg
rent_hälsofarligt	neg
rent_krasst	neg
rent_kriminellt	neg
rent_landsförräderi	neg
rent_livrädd	neg
rent_nonsens	neg
rent_påhitt	neg
rent_slöseri	neg
rent_tok	neg
ren_utpressning	neg
ren_vetenskapsbluff	neg
resa_bort	pos
reser_bort	pos
riktiga_problemet	neg
riktig_byfåne	neg
riktig_influensa	neg
riktig_källa	pos
riktig_otur	neg
riktigt_allvarliga	neg
riktigt_bekymrad	neg
riktigt_besviken	neg
riktigt_besvärligt	neg
riktigt_brant	neg
riktigt_bra	pos
riktigt_dåliga	neg
riktigt_dålig	neg
riktigt_dåligt	neg
riktigt_efterbliven	neg
riktigt_farlig	neg
riktigt_fina	pos
riktigt_friska	pos
riktigt_fult	neg
riktigt_förbannad	neg
riktigt_galet	neg
riktigt_goda	pos
riktigt_gott	pos
riktigt_gött	pos
riktigt_harmonierade	pos
riktigt_hemska	neg
riktigt_häftig	pos
riktigt_häftigt	pos
riktigt_illa	neg
riktigt_jobbiga	neg
riktigt_jobbig	neg
riktigt_jobbigt	neg
riktigt_korkat	neg
riktigt_kul	pos
riktigt_kämpigt	neg
riktigt_ledsamt	neg
riktigt_lovande	pos
riktigt_läskigt	neg
riktigt_lömsk	neg
riktigt_mysig	pos
riktigt_obehagligt	neg
riktigt_oberoende	neg
riktigt_olycklig	neg
riktigt_ont	neg
riktigt_oroad	neg
riktigt_orolig	neg
riktigt_oroväckande	neg
riktigt_osmakligt	neg
riktigt_overkligt	neg
riktigt_petig	neg
riktigt_rädd	neg
riktigt_rätt	pos
riktigt_sjuka	neg
riktigt_sjuk	neg
riktigt_skicklig	pos
riktigt_skräckscenario	neg
riktigt_skrämmande	neg
riktigt_sköra	neg
riktigt_sköra_äldre	neg
riktigt_smutsiga	neg
riktigt_snett	neg
riktigt_stressiga	neg
riktigt_sunt	pos
riktigt_surt	neg
riktigt_svåra	neg
riktigt_svår	neg
riktigt_svårt	neg
riktigt_tragiskt	neg
riktigt_tråkigt	neg
riktigt_tuffa	neg
riktigt_tufft	neg
riktigt_tung	neg
riktigt_tungt	neg
riktigt_turbulent	neg
riktigt_upprörd	neg
riktigt_usla	neg
riktigt_äckligt	neg
risky_business	neg
rista_blodsörn	neg
rista_blodörn	neg
riva_upp	neg
roar_sig	pos
roa_sig	pos
rubbat_luktsinne	neg
rusar_i_höjden	pos
ruskigt_snabba	pos
rustade_ner	neg
rusta_ner	neg
rusta_opp	pos
rustar_ner	neg
rustat_ner	neg
rusta_upp	pos
rycka_på_axlarna	neg
rycka_upp	pos
rycka_upp_sig	pos
rycker_upp	pos
rygga_tillbaka	neg
rynka_pannan	neg
rynkar_pannan	neg
rysk_roulette	neg
rysk_roulett	neg
räta_ut	pos
rätta_till	pos
rätt_beslut	pos
rätt_ok	pos
rätt_riktning	pos
rätt_spår	pos
rätt_strategi	pos
rätt_sugen	pos
röda_hund	neg
röd_av_ilska	neg
sade_upp_sig	neg
saknar_betydelse	neg
saknar_botemedel	neg
saknar_empati	neg
saknar_evidens	neg
saknar_frihet	neg
saknar_förmåga	neg
saknar_förmågan	neg
saknar_förståelse	neg
saknar_förtroende	neg
saknar_grund	neg
saknar_kompetens	neg
saknar_kreativitet	neg
saknar_kunskap	neg
saknar_resurser	neg
saknar_solidaritet	neg
saknar_stöd	neg
saknar_sympati	neg
saknar_tankeförmåga	neg
saknar_tillgång	neg
saknar_transparens	neg
saknar_trovärdighet	neg
saknar_värde	neg
saktade_ner	neg
sakta_ner	pos
samhällets_mest_utsatta	neg
samla_ihop	pos
satanisk_plan	neg
sataniskt	neg
satanistiska_barnamord	neg
satans_tvärsäker	neg
satsar_för_fullt	pos
se_genom_fingrarna	pos
se_ned	neg
se_upp	pos
sexuella_närmanden	neg
sexuellt_överförbar	neg
shut_up	neg
sitta_bra	pos
sitta_fint	pos
sitta_inne	neg
sjuka_konspirationsvärld	neg
sjukdomar_utrotats	pos
sjukt_bra	pos
sjukt_goa	pos
sjukt_viktigt	pos
sjunker_risken	pos
sju_resor_värre	neg
skar_ned	neg
skar_ner	neg
skinande_rent	pos
skiter_fullständig	neg
skiter_fullständigt	neg
skjuta_i_sig	neg
skjuta_upp	neg
skjuta_över_målet	neg
skjuter_upp	neg
skjutits_upp	neg
skrattretande_dumt	neg
skruvade_upp	neg
skruvar_lösa	neg
skruva_upp	neg
skrämma_bort	neg
skrämmande_nog	neg
skrämmande_resultat	neg
skrämma_upp	neg
skrämt_upp	neg
skuldsättning	neg
skum_artikel	neg
skyddande_effekt	pos
skylla_på	neg
skällde_ut	neg
skämma_bort	neg
skämmer_bort	pos
skära_i_ögonen	neg
skära_ned	neg
skära_ner	neg
skära_sig	neg
skärpa_sig	pos
skön_träningsvärk	pos
sköraste_äldre	neg
sköra_äldre	neg
skörda_allt_fler_liv	neg
skördade_allt_fler_liv	neg
skördade_flera_liv	neg
skördade_fler_liv	neg
skördade_liv	neg
skördade_många_liv	neg
skördade_många_människors_liv	neg
skörda_fler_liv	neg
skörda_liv	neg
skörda_många_liv	neg
skördar_allt_fler_liv	neg
skördar_fler_liv	neg
skördar_liv	neg
skördar_mest_liv	neg
skördar_många_liv	neg
skördat_allt_fler_liv	neg
skördat_fler_liv	neg
skördat_liv	neg
skördat_många_liv	neg
slagit_hårt	neg
slappna_av	pos
slappnar_av	pos
slita_sönder	neg
slog_hårt	neg
slå_dank	neg
slå_hårt	neg
slå_ihjäl	neg
slå_klackarna_i_taket	pos
slå_med_häpnad	pos
slå_ned_modet	neg
slå_på_fingrarna	pos
slår_hårt	neg
slår_ihjäl	neg
slår_sönder	neg
slår_ut_viruset	pos
slå_sig_till_ro	pos
slå_sönder	neg
slå_tillbaka	neg
slå_ut_viruset	pos
slå_väl_ut	pos
släppa_gäcken_lös	pos
släppa_igenom	pos
släppta_restriktioner	pos
slösa_bort	neg
smitta_ned	neg
smitta_ner	neg
smittar_ner	neg
smittat_blod	neg
smula_ner	neg
smyga_sig_in	neg
smyger_sig_in	neg
små_biverkningar	pos
smälta_in	pos
snabbast_växande	pos
snabbt_på_banan	pos
snabbt_växande	pos
snuva_ned	neg
snygga_till	pos
snygga_upp	pos
snälla_du	neg
sociala_distanseringen	neg
social_aktivitet	pos
sociala_sammanhanget	pos
sociala_sammanhang	pos
social_distancing	neg
social_distansering	neg
social_distans	neg
social_fobi	neg
social_gemenskap	pos
social_isolering	neg
social_kontroll	neg
social_ojämlikhet	neg
social_stigmatisering	neg
socialt_sammanhang	pos
socialt_umgänge	pos
social_utsatthet	neg
socker_lager	neg
som_en_öppen_bok	pos
som_tur_är	pos
som_är_änka	neg
sorgligt_nog	neg
sosse_diktatur	neg
spamma_ner	neg
spanska_sjukan	neg
spanska_sjukans	neg
sparka_arsel	pos
sparka_röv	pos
spela_in	pos
spelar_upp	pos
spela_upp	pos
spola_ned	pos
spola_ner	pos
springa_fram	neg
springa_in	neg
spring_iväg	neg
spring_ner	neg
spränga_banken	pos
spårade_av	neg
spårar_av	neg
spåra_ur	neg
spårlöst_borta	neg
spårlöst_försvunnen	neg
stabilt_dåligt	neg
stapla_upp	neg
starka_biverkningar	neg
starka_bokslutsrapporter	pos
starka_ekonomiska_intressen	neg
starka_förhoppning	pos
starka_immunsvar	pos
starka_intryck	pos
starka_ledare	pos
starka_positiva	pos
starka_reaktioner	pos
starkare_immunitet	pos
starkare_skydd	pos
starka_restriktioner	neg
starka_statsfinanser	pos
starkaste_ordalag	neg
starkast_intryck	pos
stark_kritik	neg
stark_press	neg
stark_sammanhållning	pos
starkt_avskräckande	neg
starkt_engagemang	pos
starkt_försvar	pos
starkt_fötroende	pos
starkt_immunförsvar	pos
starkt_immunsvar	pos
starkt_intryck	pos
starkt_kritiska	neg
starkt_kritisk	neg
starkt_positiv	pos
starkt_skydd	pos
starkt_stöd	pos
stoppade_smitta	pos
stoppa_smitta	pos
stoppa_smittspridningen	pos
stora_brister	neg
stor_belastning	neg
stor_brist	neg
stor_erfarenhet	pos
stor_framgång	pos
stor_frustration	neg
stor_fördel	pos
stor_förvirring	neg
stor_hjälp	pos
stor_kapacitet	pos
stor_kostnad	neg
stor_kritik	neg
stor_kränkning	neg
stor_möjlighet	pos
stor_nytta	pos
stor_och_tung	neg
stor_oro	neg
stor_osäkerhet	neg
stor_potential	pos
stor_press	neg
stor_påfrestning	neg
stor_risken	neg
stor_risk	neg
stor_samhällsspridning	neg
stor_skada	neg
stor_skandal	neg
stor_smitta	neg
stor_smittspridningen	neg
stor_smittspridning	neg
stor_sorg	neg
stor_säkerhet	pos
stort_allvar	pos
stort_ansvar	pos
stor_tilltro	pos
stort_lass	neg
stort_mörkertal	neg
stor_trängsel	neg
stor_vana	pos
stor_vilja	pos
stor_virusspridning	neg
stor_vårdskuld	neg
stressades_fram	neg
stressa_fram	neg
stressa_upp_sig	neg
strider_mot	neg
strunta_i	neg
strålande_humör	pos
sträcka_på_sig	pos
sträcker_sig	pos
strängare_restriktioner	neg
styra_människor	neg
stå_emot	pos
stå_still	neg
stå_ut	pos
städa_undan	pos
ställa_till_rätta	pos
stänka_ner	neg
stödjer_inte	neg
större_ansvar	pos
större_bekymmer	neg
större_chans	pos
större_effekt	pos
större_frihet	pos
större_förtroende	pos
större_hot	neg
större_immunitet	pos
större_inskränkningar	neg
större_intresse	pos
större_intryck	pos
större_kaos	neg
större_klyftor	neg
större_konsekvenser	neg
större_kris	neg
större_marginal	pos
större_misstro	neg
större_motstånd	neg
större_mörkertal	neg
större_nedgångar	neg
större_nedgång	neg
större_nytta	pos
större_nöd	neg
större_olycka	neg
större_operation	neg
större_oro	neg
större_polarisering	neg
större_problem	neg
större_påfrestning	neg
större_påverkan	neg
större_restriktioner	neg
större_risker	neg
större_risk	neg
större_skada	neg
större_skydd	pos
större_smitta	neg
större_smittspridning	neg
större_stöd	pos
större_tilltro	pos
större_transparens	pos
större_trygghet	pos
större_trängsel	neg
större_utbrott	neg
större_ödmjukhet	pos
största_företagsskandalerna	neg
största_skandalen	neg
största_skandalerna	neg
största_skandaler	neg
störst_risk	neg
suddar_ut	neg
sunda_förnuftet	pos
sund_skepsis	pos
svagare_resultat	neg
svagt_nedåt	neg
svagt_positiv	pos
svagt_positivt	pos
svarta_börsen	neg
svarta_döden	neg
svarta_marknaden	neg
svart_i_synen	neg
svimma	neg
svimmar	neg
svåra_konsekvenser	neg
svårare_konsekvenser	neg
svår_biverkning	neg
svår_situation	neg
svårt_att_acceptera	neg
svårt_att_andas	neg
svårt_att_bevisa	neg
svårt_att_förklara	neg
svårt_att_förstå	neg
svårt_att_motivera	neg
svårt_att_sova	neg
svårt_att_svälja	neg
svårt_att_uppdatera	neg
svårt_att_uppnå	neg
svårt_covidsjuka	neg
svårt_covidsjuka_äldre	neg
svårt_funktionsnedsatta	neg
svårt_nog	neg
svårt_problem	neg
svårt_sjuka	neg
svårt_sjuk	neg
svårt_utbrott	neg
svårt_utsatt	neg
svälta_ut	neg
svärta_ner	neg
symptomfria_äldre	pos
synlig_katastrof	neg
så_fan_heller	neg
så_in_i_helvete	neg
så_kal	neg
så_svikna	neg
sämre_effekt	neg
sämre_förutsättningar	neg
sämre_läge	neg
sämre_möjlighet	neg
sämre_prognos	neg
sämre_rustade	neg
sämre_rustad	neg
sämre_skydd	neg
sämre_utfall	neg
sämre_utveckling	neg
sämsta_sort	neg
sämst_nog	neg
särskilt_intressant	pos
särskilt_svårt	neg
särskilt_tragiskt	neg
särskilt_uppmuntrande	pos
särskilt_utsatta	neg
särskilt_utsatt	neg
särskilt_utsatt_riskgrupp	neg
sätta_dit	neg
sätta_i_halsen	neg
ta_av_sig	pos
tackade_nej	neg
tacka_nej	neg
tackar_nej	neg
tackat_nej	neg
tack_men_nej_tack	neg
tack_och_lov	pos
tack_vare	pos
tack_å_lov	pos
ta_emot	pos
ta_fram	pos
tagit_kål_på	neg
ta_igen_sig	pos
tala_sanning	pos
tala_väl	pos
tappa_bort	neg
tappa_modet	neg
tappar_bort	neg
tappas_bort	neg
tappat_bort	neg
tappats_bort	neg
tar_fram	pos
tar_illa_upp	neg
tar_sig_i_brasan	neg
tar_sig_i_röven	neg
tar_slut	neg
tar_över	pos
ta_sig_an	pos
ta_sig_där_bak	neg
ta_sig_i_arschlet	neg
ta_sig_i_arslet	neg
ta_sig_i_brasan	neg
ta_sig_i_röven	neg
ta_sig	pos
ta_sig_uppåt	pos
taskigt_beteende	neg
ta_slut	neg
ta_tillbaka	neg
ta_till_lipen	neg
ta_till_nåder	pos
ta_väldigt_illa_vid	neg
tekniskt_fel	neg
tekniskt_obevandrade	neg
testat_negativt	pos
testat_positivt	neg
testats_negativt	pos
testats_positivt	neg
<thumbs-down>	neg
<thumbs-up>	pos
till_lags	pos
tillräcklig_kunskap	pos
tillräckligt_bra	pos
tillräckligt_effektivt	pos
tillräckligt_god	pos
tillräckligt_gott	pos
tillräckligt_illa	neg
tillräckligt_skydd	pos
tillräckligt_stöd	pos
tillräckligt_säkert	pos
tillräckligt_tillförlitliga	pos
tillskansa_sig	neg
tilltagande_smittspridning	neg
tjäna_in	neg
tomma_ord	neg
tomtar_på_loftet	neg
tonade_ned	neg
tona_ned	neg
tonar_ned	neg
tragiska_konsekvenserna	neg
tragiska_konsekvenser	neg
tragisk_milstolpe	neg
tragiskt_nog	neg
trampa_ner	neg
tramsiga_vaccinationsmotståndet	neg
trassla_in	neg
trilla_av	neg
trilla_ner	neg
trillar_av	neg
trillar_ner	neg
trixat_nog	neg
trycka_ned_i_skoskaften	neg
tråka_ut	neg
tråkig_känsla	neg
tuffare_lockdown	neg
tuffare_tider	neg
tufft_nog	neg
tumme_ner	neg
<tummen_ner>	neg
tummen_ner	neg
<tummen_upp>	pos
tummen_upp	pos
tunga_experter	pos
tunga_hjärtan	neg
tunga_institutioner	pos
tunga_läget	neg
tunga_samtal	neg
tunga_steg	neg
tunga_stimulanspaket	pos
tunga_vintern	neg
tung_belastning	neg
tung_insikt	neg
tung_kritik	neg
tung_situation	neg
tungt_ansvar	neg
tungt_arbete	neg
tungt_belastade	neg
tungt_belastad	neg
tungt_besked	neg
tungt_beslut	neg
tungt_hjärta	neg
tungt_jobb	neg
tungt_lass	neg
tungt_läge	neg
tungt_meriterade	pos
tung_uppgift	neg
tur_i_oturen	pos
tveksamt_nog	neg
tvinga_fram	neg
två_ansikten	neg
tvärlågt_förtroende	neg
tvätta_av	pos
tvätta_bort	pos
tvättade_bort	pos
tvätta_pengar	neg
tvättar_pengar	neg
tycka_om	pos
tydliga_besked	pos
tydlig_diskriminering	neg
tydlig_evidens	pos
tydlig_förbättring	pos
tydlig_risk	neg
tydlig_skillnad	pos
tydligt_fokus	pos
tysta_ner	neg
tyvärr_nog	neg
tål_inte	neg
täckt_med_socker	neg
tänka_om	pos
tänka_själva	pos
tänker_om	pos
täppa_till	neg
ultrahård_linje	neg
undandra_sig	neg
under_all_kritik	neg
under_isen	neg
underkasta_sig	neg
underliggande_hälsoproblem	neg
underliggande_sjukdomar	neg
underliggande_sjukdom	neg
undermedvetet_påverkat	neg
unna_sig	neg
upphöjande_av_forskare_till_skyarna	pos
uppseendeväckande_rapport	neg
ur_balans	neg
ur_funktionen	neg
ur_funktion	neg
ur_gängorna	neg
ur_lag	neg
ur_spel	neg
utan_allvarliga_biverkningar	pos
utan_allvarliga_effekter	pos
utan_allvarliga_problem	pos
utan_anmärkning	pos
utan_feber	pos
utan_framgång	neg
utan_hjälp	neg
utan_hänsyn	neg
utan_inkomst	neg
utan_intresse	neg
utan_jobb	neg
utan_komplikationer	pos
utan_känslor	neg
utan_läkarvård	neg
utan_mål	neg
utan_problem	pos
utan_restriktioner	pos
utan_risk	pos
utan_rädsla	pos
utan_skam	pos
utan_skydd	neg
utan_stöd	neg
utan_symptom	pos
utan_symtom	pos
utan_tillstånd	neg
utan_tvekan	pos
utan_tvivel	pos
utan_urskillning	neg
utan_vinstintresse	pos
utan_vård	neg
utan_vänner	neg
ute_och_cyklar	neg
ute_o_cyklar	neg
ute_på_hal_is	neg
ute_å_cyklar	neg
utkräva_hämnd	neg
utmärker_sig	pos
utom_sig	neg
utrota_corona	pos
utrota_covid-19	pos
utrotade_sjukdomar	pos
utrotade_smittan	pos
utrotar_corona	pos
utrotar_covid-19	pos
utrotar_sjukdomar	pos
utrotar_sjukdomen	pos
utrotar_smittan	pos
utrotar_viruset	pos
utrota_sjukdomar	pos
utrota_sjukdomen	pos
utrota_smittan	pos
utrotat_sjukdomar	pos
utrotat_smittan	pos
utrota_viruset	pos
utvecklar_sig	pos
utveckla_sig	pos
utöver_det_vanliga	pos
vad_fan	neg
vad_fasiken	neg
vad_obehagligt	neg
va_fan	neg
vaknat_till	pos
vanlig_biverkning	neg
vara_med	pos
varit_utom_sig	neg
varma_kakor	pos
varm_tårta	pos
varvar_upp	pos
varva_upp	pos
waste_of_life	neg
vatten_ner	neg
verklig_kris	neg
vete_fan	neg
vetenskaplig_källa	pos
vettig_källa	pos
vid_liv	pos
vifta_på_svansen	pos
vika_ner_sig	neg
vila_i_frid	neg
vilja_sig	pos
vilseledande_information	neg
vinna_segerpalmen	pos
visar_upp	pos
visa_upp	pos
viss_trygghet	pos
vrida_sig	neg
vräka_sig	pos
vräker_sig	pos
våldsamt_slag	neg
vädigt_allvarstyngt	neg
väl_ansedd	pos
väl_ansluten	pos
väl_avrundad	pos
väl_bakgrundsbelyst	pos
väl_dokumenterad	neg
väl_fungerande	pos
väl_förberedda	pos
väl_förberedd	pos
väl_förberett	pos
väl_mottaget	pos
väl_positionerade	pos
väl_positionerad	pos
väl_rustade	pos
vältra_sig	neg
väl_unt	pos
väl_uppfödda	pos
vända_till_det_bättre	pos
vänder_till_det_bättre	pos
vänliga_hälsningar	pos
vänta_fortfarande	neg
vänta_i_evigheter	neg
vänta_på_hjälp	neg
väntar_fortfarande	neg
väntar_i_evigheter	neg
väntar_på_hjälp	neg
värka_ut	pos
värker_ut	pos
värnar_om	pos
värst_drabbade	neg
värst_drabbad	neg
ytterligare_förbättra	pos
ytterligare_restriktioner	neg
yttre_hot	neg
åka_dit	pos
åkte_dit	pos
ångrade_sig	pos
ångrar_sig	pos
ångra_sig	pos
ångrat_sig	pos
återhämtade_sig	pos
återhämtar_sig	pos
återhämta_sig	pos
återhämtat_sig	pos
åt_h-vete	neg
ägna_sig	pos
älskar_sig	pos
ökade_dödligheten	neg
ökad_risk	neg
ökat_våld	neg
ökat_välbefinnande	pos
öppen_krigsförklaring	neg
över_min_döda_kropp	neg
