aborterade_foster	neg	-2
akta_sig	neg	-2
akuta_tillstånd	neg	-2
alarmerande_dåligt	neg	-2
alarmerande_högt	neg	-2
alarmerande_utveckling	neg	-2
aldrig_i_helvete	neg	-2
aldrig_i_livet	neg	-2
aldrig_mer_i_mitt_liv	neg	-3
allena_saliggörande	pos	2
allergiska_reaktioner	neg	-2
all_time_high	pos	2
allvarliga_bieffekter	neg	-2
allvarliga_brister	neg	-2
allvarliga_effekter	neg	-2
allvarliga_följder	neg	-2
allvarliga_hälsorisker	neg	-2
allvarliga_händelser	neg	-2
allvarliga_infektioner	neg	-2
allvarliga_komplikationer	neg	-2
allvarliga_konsekvenser	neg	-2
allvarliga_läget	neg	-2
allvarliga_problem	neg	-2
allvarliga_reaktioner	neg	-2
allvarligare_bieffekter	neg	-2
allvarligare_läge	neg	-2
allvarligare_reaktioner	neg	-2
allvarligare_rubbning	neg	-2
allvarliga_risker	neg	-2
allvarliga_riskfaktorer	neg	-2
allvarliga_skador	neg	-2
allvarliga_symptomen	neg	-2
allvarliga_symptom	neg	-2
allvarliga_symtom	neg	-2
allvarliga_tillbud	neg	-2
allvarliga_tillstånd	neg	-2
allvarlig_biverkning	neg	-2
allvarlig_brist	neg	-2
allvarlig_försämring	neg	-3
allvarlig_karaktär	neg	-2
allvarlig_kris	neg	-2
allvarlig_oro	neg	-2
allvarlig_påverkan	neg	-2
allvarlig_risk	neg	-2
allvarlig_situationen	neg	-2
allvarlig_situation	neg	-2
allvarlig_störning	neg	-2
allvarligt_brott	neg	-2
allvarligt_läget	neg	-2
allvarligt_problem	neg	-2
allvarligt_sjukdomsförlopp	neg	-2
allvarligt_smittläge	neg	-2
allvarlig_utveckling	neg	-2
ana_ugglor_i_mossen	neg	-2
andra_klass	neg	-2
andra_nivån	neg	-2
ansluta_sig	pos	2
arta_sig	pos	2
autoimmuna_reaktioner	neg	-2
autoimmuna_reaktion	neg	-2
autoimmuna_sjukdomar	neg	-2
autoimmune_disease	neg	-2
autoimmun_reaktion	neg	-2
autoimmun_sjk	neg	-2
autoimmun_sjukdom	neg	-2
av_guds_nåde	pos	2
avgå_med_segern	pos	2
av_största_vikt	pos	2
avsäga_sig	neg	-2
bad_news	neg	-2
bad_om_ursäkt	pos	2
bakomliggande_hälsoproblem	neg	-2
bakomliggande_sjukdomar	neg	-2
bakomliggande_sjukdom	neg	-2
bakomliggande_sjuklighet	neg	-2
bakom_lås_och_bom	neg	-2
banne_mig	neg	-1
banne_mig	neg	-2
bedrövlig_nog	neg	-2
be_förbehållslöst_om_ursäkt	pos	2
begränsad_kapacitet	neg	-2
belasta_sjukvården	neg	-2
be_om_förlåtelse	pos	2
be_om_ursäkt	pos	2
berg_och_dalbana	neg	-2
ber_inte_om_ursäkt	neg	-2
ber_mycket_om_ursäkt	pos	2
ber_om_ursäkt	pos	2
ber_verkligen_om_ursäkt	pos	2
beskäftig_person	neg	-2
besluta_sig	pos	2
besvära_sig	neg	-2
betala_sig	pos	2
be_om_ursäkt	pos	2
betydligt_mer	pos	2
bevisad_effekt	pos	2
be_världen_om_ursäkt	pos	2
bister_uppsyn	neg	-2
biter_i_det_sura_äpplet	neg	-2
blanda_in	neg	-2
blanda_sig_i	neg	-2
blind_tilltro	neg	-2
blint_lita	neg	-1
bli_rik	neg	-2
bli_över	pos	2
bluff_och_båg	neg	-2
blåst_på_konfekten	neg	-2
bortom_all_räddning	neg	-2
bortse_från	neg	-2
bortser_från	neg	-2
bortses_från	neg	-2
boven_i_dramat	neg	-2
bra_budskap	pos	2
bra_effekt	pos	2
bra_förmåga	pos	2
bra_förutsättningar	pos	2
bra_gjord	pos	2
bra_grepp	pos	2
bra_grund	pos	2
bra_hanterat	pos	2
bra_idéer	pos	2
bra_ide	pos	2
bra_idé	pos	2
bra_jobbat	pos	2
brakade_loss	neg	-1
bra_komplement	pos	2
bra_kontroll	pos	2
bra_liv	pos	2
bra_lösning	pos	2
bra_prestanda	pos	2
bra_resultat	pos	2
bra_rutiner	pos	2
bra_råd	pos	2
bra_samarbete	pos	2
bra_skarp	pos	2
bra_skydd	pos	2
bra_start	pos	2
bra_stöd	pos	2
bra_tryck	pos	2
bra_underlag	pos	2
bra_upplösning	pos	2
bra_utgångsläge	pos	2
bra_vaccin	pos	2
bra_åtgärd	pos	2
bristande_effektivitet	neg	-2
bristande_förmåga	neg	-2
bristande_förståelse	neg	-2
bristande_hygienrutiner	neg	-2
bristande_intelligens	neg	-2
bristande_karaktär	neg	-2
bristande_kompetens	neg	-2
bristande_kunskaper	neg	-2
bristande_kunskap	neg	-2
bristande_källkritik	neg	-2
bristande_läskunnighet	neg	-2
bristande_prestanda	neg	-2
bristande_rutiner	neg	-2
bristande_säkerhet	neg	-2
bristande_tankeförmåga	neg	-2
bristande_transparens	neg	-2
bristande_verklighetsuppfattning	neg	-2
brist_på_sammanhang	neg	-2
brott_mot_mänskligheten	neg	-2
brusa_upp	neg	-2
brutalt_dumma	neg	-2
brutalt_dum	neg	-2
brydde_mig	pos	2
brydde_sig	pos	2
bry_mig	pos	2
bryr_dig	pos	2
bryr_mig	pos	2
bryr_sig	pos	2
bry_sig	pos	2
bryta_ned	neg	-2
bryta_ner	neg	-2
bryter_mot	neg	-2
bryter_ned	neg	-2
bud_riggning	neg	-2
bygga_ut	pos	2
bära_frukt	pos	2
bära_i_gullstol	pos	2
bära_sig	pos	2
bäst_presterande	pos	2
bättra_på	pos	2
bättra_sig	pos	2
bättre_förutsättningar	pos	2
bättre_koll	pos	2
bättre_läge	pos	2
bättre_möjligheter	pos	2
bättre_resultat	pos	2
bättre_rustade	pos	2
bättre_rustad	pos	2
bättre_rustat	pos	2
bättre_sammanhållning	pos	2
bättre_tillgång	pos	2
bättre_uppfattning	pos	2
bättre_villkor	pos	2
bättre_än_förväntat	pos	2
bättre_överblick	pos	2
bönade_och_bad	neg	-2
böna_och_be	neg	-2
coola_saker	pos	2
corona-krisens_spår	neg	-2
covid_19	neg	-2
covidsjuka_äldre	neg	-2
covid_utrotas	pos	2
dela_med_sig	pos	2
det_är_där_skon_klämmer	neg	-2
diaboliska_globalistplanen	neg	-2
diaboliskt_plan	neg	-2
direkt_felaktigt	neg	-2
direkt_fel	neg	-2
diska_av	pos	2
djupt_beklaga	neg	-2
djupt_beklagligt	neg	-2
djupt_tragiskt	neg	-2
d_*_mn	neg	-2
dold_agenda	neg	-2
down_syndrom	neg	-2
drabbades_extra_hårt	neg	-2
drabbades_hårdare	neg	-2
drabbas_allvarligare	neg	-2
drabbas_extra_hårt	neg	-2
drabbas_hårdare	neg	-2
drabbas_hårdast	neg	-3
drabbas_hårt	neg	-2
drabbas_svårt	neg	-2
drabbas_värst	neg	-2
drabbats_hårdare	neg	-2
drabbats_hårt	neg	-2
dra_ett_streck	pos	2
dra_fram	neg	-2
dra_in	neg	-2
dramatiska_besked	neg	-2
dramatiska_effekter	neg	-2
dramatiska_känslor	neg	-2
dramatiska_siffror	neg	-2
dramatiska_utvecklingen	neg	-2
dramatiskt_förlopp	neg	-2
dramatiskt_sätt	neg	-2
dramatisk_utveckling	neg	-2
dra_nytta	pos	2
dra_på_smilbanden	pos	2
drar_fram	neg	-2
drar_upp	pos	2
drar_ut_på_tiden	pos	2
drastiskt_förändrad	neg	-2
dra_tillbaka	neg	-2
dra_upp	pos	2
dra_ut_på_tiden	pos	2
dra_åt_helvete	neg	-2
drog_sig_tillbaka	neg	-2
duktiga_idioter	neg	-2
dum_i_huvudet	neg	-2
dumma_huvudet	neg	-2
dumma_nog	neg	-2
dyrbart_fiasko	neg	-2
dyster_bild	neg	-2
dyster_milstolpe	neg	-2
dyster_rekordsiffra	neg	-2
dystert_dagsrekord	neg	-2
dystert_dygnsrekord	neg	-2
dyster_toppnotering	neg	-2
dystert_rekord	neg	-2
dyster_trend	neg	-2
dystert_virusläge	neg	-2
dystert_virusrekord	neg	-2
dystert_världsrekord	neg	-2
dyster_vår	neg	-2
dystra_beskedet	neg	-2
dystra_besked	neg	-2
dystra_coronarekord	neg	-2
dystra_coronasiffror	neg	-2
dystra_dygnsrekord	neg	-2
dystra_facit	neg	-2
dystra_milstolpar	neg	-2
dystra_milstolpen	neg	-2
dystra_prognosen	neg	-2
dystra_rekordet	neg	-2
dystra_rekord	neg	-2
dystra_rekordsiffror	neg	-2
dystra_siffra	neg	-2
dystra_siffrorna	neg	-2
dystra_siffror	neg	-2
dystra_tider	neg	-2
dystra_till	neg	-2
dystra_världsrekord	neg	-2
dåliga_levnadsvanor	neg	-2
dålig_användning	neg	-2
dålig_effektivitet	neg	-2
dålig_hjälp	neg	-2
dålig_hälsa	neg	-2
dålig_immunitet	neg	-2
dålig_kvalitet	neg	-2
dålig_prognos	neg	-2
dålig_psykisk_hälsa	neg	-2
dålig_självkänsla	neg	-2
dålig_strategi	neg	-2
dåligt_använda	neg	-2
dåligt_bemötande	neg	-2
dålig_tillgång	neg	-2
dåligt_immunförsvar	neg	-2
dåligt_omdöme	neg	-2
dåligt_rustade	neg	-2
dåligt_rykte	neg	-2
dåligt_råd	neg	-2
dåligt_samvete	neg	-2
dåligt_skydd	neg	-2
dåligt_skämt	neg	-2
dåligt_sorterad	neg	-2
dåligt_tecken	neg	-2
dåligt_utformad	neg	-2
dålig_utgångspunkt	neg	-2
dålig_utsikt	neg	-2
dålig_överblick	neg	-2
dämpande_effekt	pos	2
dödliga_giftet	neg	-2
dödliga_våldet	neg	-2
dödlig_sjukdom	neg	-2
dödssprutan	neg	-2
dö_som_flugor	neg	-2
effektivare_stridsmedel	neg	-2
effektivt_skydd	pos	2
egoistisk_prägel	neg	-2
ekonomiska_klyftorna	neg	-2
ekonomiska_marginaler	pos	2
ekonomisk_nedgång	neg	-2
ekonomiskt_stöd	pos	2
elitistisk_skara	neg	-2
empatilösa_svin	neg	-2
energi_sparande	pos	2
en_gång_i_livet	pos	2
en_het_potatis	neg	-2
enorm_vrede	neg	-2
ensamma_äldre	neg	-2
erbarmeliga_tystnadskultur	neg	-2
etiska_dilemman	neg	-2
etter_värre	neg	-2
extra_hårt	neg	-2
extra_noga	pos	2
extrema_åsikter	neg	-2
extrem_fattigdom	neg	-3
extrem_fetma	neg	-3
extrem_påfrestning	neg	-3
extrem_risk	neg	-3
extrem_situation	neg	-3
extremt_allvarliga	neg	-3
extremt_allvarlig	neg	-3
extremt_allvarligt	neg	-3
extremt_behov	neg	-3
extremt_bra	pos	3
extremt_noga	pos	3
extremt_sköra	neg	-3
extremt_svår	neg	-3
extremt_svårt	neg	-3
extremt_tydliga	pos	3
fake_news	neg	-2
falla_in	pos	2
falla_samman	pos	2
falla_sönder	neg	-2
faller_ihop	neg	-2
faller_sönder	neg	-2
faller_trovärdigheten	neg	-2
falska_nyheter	neg	-2
falska_positiva	neg	-2
falska_positiv	neg	-2
falsk_marknadsföring	neg	-1
falsk_positiv	neg	-2
falskt_negativa	neg	-2
falskt_negativt	neg	-2
falskt_positiva	neg	-2
falskt_positiv	neg	-2
falskt_positivt	neg	-2
falsk_trygghet	neg	-2
fanskaps_kvackare	neg	-2
fantastisk_milstolpe	pos	2
fantastiskt_bra	pos	2
fantastiskt_roligt	pos	2
farligt_nog	neg	-2
fast_besluten	pos	2
fastnade_i_musfällan	neg	-2
fatta_beslut	pos	2
felakrig_demokrati	neg	-2
fel_sort	neg	-1
fel_tillfälle	neg	-2
feta_arvoden	neg	-2
feta_katter	neg	-2
fet_katt	neg	-2
fet_skandal	neg	-2
fick_nog	neg	-2
fiffa_opp	pos	2
fiffa_upp	pos	2
fina_fisken	pos	2
finaste_sort	pos	2
finnas_i_överflöd	pos	2
fin_sammanhållning	pos	2
fixade_fram	pos	2
fjärde_statsmakten	neg	-2
f_**_k	neg	-2
flippar_ur	neg	-2
flippa_ur	neg	-2
fortsatt_bra	pos	2
frigöra_resurser	pos	1
frigör_resurser	pos	1
friska_upp	pos	2
friskna_till	pos	2
frivilliga_aborter	neg	-1
frivilliga_restriktioner	neg	-1
frivillig_distansering	neg	-1
frivillig_ensamhet	neg	-1
frivillig_hemkarantän	neg	-1
frivillig_isolering	neg	-1
frivillig_karantän	neg	-1
frivillig_lockdown	neg	-1
frivillig_självisolering	neg	-1
fruktansvärda_nyheter	neg	-2
fruktansvärd_utveckling	pos	2
fruktansvärt_bra	pos	3
fruktansvärt_ensam	neg	-2
fruktansvärt_jobbigt	neg	-2
frysa_ut	neg	-2
fucking_mongos	neg	-2
fulla_kraft	neg	-2
full_aktivitet	pos	1
full_av_liv	pos	2
full_bra	pos	2
full_frisk	pos	2
full_förståeligt	pos	2
full_förståelse	pos	2
full_koll	pos	2
fullkomlig_panik	neg	-2
fullkomligt_irrelevant	neg	-2
fullkomligt_vanvett	neg	-2
fullkomligt_vettlöst	neg	-2
full_kunskap	pos	2
full_panik	neg	-2
full_respekt	pos	2
full_rättighet	pos	2
full_säkerhet	pos	2
fullt_beredvilliga	pos	2
fullt_friska	pos	2
fullt_frisk	pos	2
fullt_fungerande	pos	2
fullt_förståeligt	pos	2
fullt_förtroende	pos	2
fullt_förväntat	pos	2
fullt_krig	neg	-2
fullt_logisk	pos	2
fullt_med_folk	neg	-2
fullt_möjligt	pos	2
fullt_naturligt	pos	2
fullt_normalt	pos	2
full_transparens	pos	2
fullt_rationella	pos	2
fullt_rationell	pos	2
fullt_rimliga	pos	2
fullt_rimligt	pos	2
fullt_skydd	pos	2
fullt_stöd_från	pos	2
fullt_trygg	pos	2
fullt_vaccinerade	pos	2
fullt_vaccinerad	pos	2
fullt_återöppnande	pos	2
full_valfrihet	pos	2
fundamentalistiska_sekter	neg	-2
fundamentalistiska_tro	neg	-2
fungera_bra	pos	2
fungerar_dåligt	neg	-2
fungerar_ej	neg	-2
fungerar_inte	neg	-2
fy_dig	neg	-2
fy_fan	neg	-2
fy_f*n	neg	-2
fy_katten	neg	-1
fyrkantiga_västlänningar	neg	-2
fysiska_aktiviteter	pos	2
fysisk_aktivitet	pos	2
fysiska_våldet	neg	-2
fysisk_distansering	neg	-2
fysisk_distans	neg	-2
fysisk_stress	neg	-2
fysiskt_aktiva	pos	2
fysiskt_ont	neg	-2
fysisk_träning	pos	2
fysiskt_sårbara	neg	-2
fysiskt_våld	neg	-2
fy_skam	neg	-2
fy_vad_jobbigt	neg	-2
får_panik	neg	-2
fått_nog	neg	-2
föga_övertygande	neg	-2
följa_upp	pos	2
följer_upp	pos	2
förbättrad_situation	pos	1
fördjupar_sig	pos	2
fördjupa_sig	pos	2
för_dyrt	neg	-2
förebyggande_arbete	pos	2
förebyggande_arbetet	pos	2
förebyggande_effekt	pos	2
förebyggande_insatser	pos	2
förebyggande_skydd	pos	2
förebyggande_åtgärderna	pos	2
förebyggande_åtgärder	pos	2
förebyggande_åtgärd	pos	2
förespråkade_våld	neg	-2
förespråkar_våld	neg	-2
förespråka_våld	neg	-2
för_f*n	neg	-2
förhindrad_spridning	pos	2
förhindra_spridningen	pos	2
förhindra_spridning	pos	2
förhöjd_risk	neg	-2
förkovrar_sig	pos	2
förkovra_sig	pos	2
förlorad_inkomst	neg	-2
förlora_jobbet	neg	-2
förlova_sig	pos	2
förringa_behovet	neg	-2
första_klass	pos	2
förställa_sig	neg	-2
försvagade_immunförsvar	neg	-2
försvagade_immunsystemet	neg	-2
försvagade_virus	pos	2
försvagat_immunförsvar	neg	-2
försvagat_immunsystem	neg	-2
försvagat_virus	pos	2
försämrad_ekonomi	neg	-2
galet_härligt	pos	3
galna_kosjukan	neg	-2
gammal_nog	neg	-1
ganska_tungt	neg	-2
gasa_ihjäl	neg	-2
gasar_ihjäl	neg	-2
gav_upp	neg	-2
ge_efter	neg	-2
ge_fan_i	neg	-2
ge_igen	neg	-2
gemene_man	neg	-2
generösa_villkor	pos	2
genetiska_förändringar	neg	-2
genmanipulation	neg	-2
ger_tillbaka	pos	2
ger_upp	neg	-2
ge_sig_av	pos	2
ge_sig	pos	2
ge_sig_på	neg	-2
ge_tillbaka	pos	2
gett_upp	neg	-2
ge_upp	neg	-2
gick_illa	neg	-2
gick_in_i_väggen	neg	-2
gick_på_knäna	neg	-2
gillar_inte	neg	-2
gjort_starkast_intryck	pos	2
gjort_större_intryck	pos	2
gjuta_olja_på_elden	neg	-2
glada_nyheter	pos	2
gladeligen_döda	neg	-2
glatt_litet	neg	-2
glimten_i_ögat	pos	2
globala_uppvärmningen	neg	-2
globaliserad_värld	neg	-2
globalisternas_nya_matrix	neg	-2
glädde_sig	pos	2
gläder_sig	pos	2
glädja_sig	pos	2
glädjer_sig	pos	2
glömskans_dy	neg	-2
gnissla_med_tänderna	neg	-2
goda_chanser	pos	2
goda_effekten	pos	2
goda_förhoppningar	pos	2
goda_förutsättningar	pos	2
goda_möjligheter	pos	2
goda_nyheter	pos	2
goda_resultaten	pos	2
goda_resultat	pos	2
goda_rutiner	pos	2
goda_råd	pos	2
goda_utsikter	pos	2
goda_vanor	pos	2
god_effekt	pos	2
god_grund	pos	2
god_hjälp	pos	2
god_hälsa	pos	2
god_kapacitet	pos	2
god_kontroll	pos	2
god_kvalitet	pos	2
god_marginal	pos	2
god_nyhet	pos	2
god_omvårdnad	pos	2
god_prognos	pos	2
god_sammanhållning	pos	2
god_skyddseffekt	pos	2
god_uppfattning	pos	2
god_vård	pos	2
gott_och_väl	pos	2
grav_fetma	neg	-3
great_reset	neg	-2
gripa_sig_an	pos	1
grov_förbrytelse	neg	-2
grovt_brott	neg	-2
grovt_smicker	pos	2
grovt_våld	neg	-2
grymt_bra	pos	2
grymt_bra	pos	3
gråta_floder	neg	-2
grönt_ljus	pos	2
grön_tvätt	neg	-2
gudi_behaglig	pos	2
gula_febern	neg	-2
gå_bra	pos	2
gå_hem	pos	2
gå_i_bitar	neg	-2
gå_ihop	pos	2
gå_i_land	pos	2
gå_illa	neg	-2
gå_i_lås	pos	2
gå_in	pos	2
gå_i_pension	pos	2
gå_i	pos	2
gå_långt	pos	2
gå_ned_sig	neg	-2
går_i_bitar	neg	-2
går_i_pension	pos	2
går_i_taket	neg	-2
går_på_knäna	neg	-2
går_utför	neg	-2
går_vidare	pos	2
gå_sönder	neg	-2
gå_till_spillo	neg	-2
gått_bort	neg	-2
gå_upp_i_limningen	neg	-3
gå_utför	neg	-2
gå_ut	pos	2
gå_vidare	pos	2
gå_vägen	pos	2
gå_över_ån_efter_vatten	neg	-2
gömde_sig	neg	-2
gömmer_sig	neg	-2
göra_gott	pos	2
göra_intryck	pos	2
göra_livet_surt	neg	-2
göra_rasande	neg	-2
göra_rätt_för_sig	pos	2
göra_sig	pos	2
göra_skäl	pos	2
göra_stan	pos	2
göra_upp_räkningen	neg	-2
gör_intryck	pos	2
habilitera_sig	pos	2
ha_en_gås_oplockad	neg	-2
halka_efter	neg	-2
halka_ner	neg	-2
halkar_efter	neg	-2
halkar_ner	neg	-2
halkat_efter	neg	-2
halkat_ner	neg	-2
happy_ending	pos	2
happy_endings	pos	2
harmas_över	neg	-2
ha_rätt	pos	2
ha_sönder	neg	-2
hatar_att_leva	neg	-3
hedersrelaterat_våld	neg	-2
heja_på	pos	2
helt_klart	pos	2
helt_lost	neg	-2
helt_ny	pos	2
helt_rätt	pos	2
hemligt_ondskefullt	neg	-2
hemsk_biverkning	neg	-2
herre_gud	neg	-1
herren_gud	pos	2
het_potatis	neg	-2
hetsats_fram	neg	-2
hetsa_upp	neg	-2
himla_go	pos	2
himla_så_smart	pos	2
hipp_som_happ	neg	-1
hjälpa_till	pos	2
hjälper_till	pos	2
hokus_pokus	neg	-2
hoppa_av	neg	-2
hoppa_hage	pos	2
hoppa_rep	pos	2
hyra_in	pos	2
hyrde_in	pos	2
hålla_i_gång	pos	2
hålla_ihop	pos	2
hålla_kontakten	pos	2
hålla_kontakt	pos	2
hålla_käften	neg	-2
hålla_käft	neg	-2
hålla_med	pos	2
hålla_måttet	pos	2
hålla_på	pos	2
hålla_sams	pos	2
hålla_sig_isolerad	neg	-1
hålla_sig	pos	2
hålla_streck	pos	2
hålla_till_godo	pos	2
hålla_ut	pos	2
håller_ihop	pos	2
håller_inte_med	neg	-2
håller_käften	neg	-2
håller_käft	neg	-2
håller_med	pos	2
håller_måttet	pos	2
håll_käften	neg	-2
håll_käft	neg	-2
hårda_krav	neg	-2
hårda_pressen	neg	-2
hårdare_coronarestriktioner	neg	-2
hårdare_krav	neg	-2
hårdare_nedstängning	neg	-2
hårdare_regler	neg	-2
hårdare_reserestriktioner	neg	-2
hårdare_restriktionerna	neg	-2
hårdare_tag	neg	-2
hårdare_åtgärder	neg	-2
hård_press	neg	-2
hård_träff	neg	-2
hårresande_beslut	neg	-1
hårt_arbetande	pos	2
hårt_drabbade	neg	-2
hårt_pressad	neg	-3
hårt_sargade	neg	-2
hårt_slag	neg	-2
håva_in	pos	2
hämmande_effekt	pos	2
hänga_läpp	neg	-2
hänga_med_huvudet	neg	-2
hänga_på_en_skör_tråd	neg	-2
hänga_sig	neg	-2
hänga_ut	neg	-2
hänger_läpp	neg	-2
hänger_med_huvudet	neg	-2
hänger_sig	neg	-2
hög_arbetsbelastning	neg	-2
höga_smittotal	neg	-2
hög_belastning	neg	-2
hög_dödlighet	neg	-2
hög_effektivitet	pos	2
hög_frånvaro	neg	-2
hög_kapacitet	pos	2
hög_kompetens	pos	2
hög_kvalitet	pos	2
hög_potential	pos	2
hög_prestanda	pos	2
hög_puls	neg	-1
högre_risk	neg	-2
hög_risk	neg	-2
hög_sjukfrånvaro	neg	-2
hög_skyddseffekt	pos	2
hög_smittorisk	neg	-2
hög_smittrisk	neg	-2
hög_smittsamhet	neg	-2
hög_smittspridning	neg	-2
högsta_grad	pos	2
högt_blodtryck	neg	-2
högt_förtroende	pos	2
hög_tilltro	pos	2
högt_mörkertal	neg	-2
högt_oroande	neg	-2
högt_pris	neg	-2
högt_skydd	pos	2
högt_tonläge	neg	-2
högt_värde	pos	2
hög_överdödlighet	neg	-2
höja_till_skyarna	pos	2
höjer_till_skyarna	pos	2
höll_med	pos	2
höll_måttet	pos	2
höna_av_en_fjäder	neg	-2
i_aktionen	pos	2
i_aktion	pos	2
i_balansen	pos	2
i_balans	pos	2
icke_godkänd	neg	-2
icke_oäven	pos	2
idiotiskt_nog	neg	-2
i_en_klass_för_sig	pos	2
i_förtvivlan	neg	-2
i_godo	pos	2
i_god_tid	pos	2
illa_behandlad	neg	-2
illa_bemött	neg	-2
illa_definierade	neg	-2
illa_däran	neg	-2
illa_formad	neg	-2
illa_rustade	neg	-2
illa_rustad	neg	-2
illa_till_mods	neg	-2
illa_tänkt	neg	-2
illa_uppfört	neg	-2
infantila_rapporteringar	neg	-2
infantil_retorik	neg	-2
inge_mod	pos	2
inget_hopp	neg	-2
injicera_ihjäl	neg	-2
injicerar_ihjäl	neg	-2
inlägga_förtjänst	pos	2
instämde_inte	neg	-2
instämmer_inte_alls	neg	-2
inte_acceptabelt	neg	-2
inte_allvarligt	pos	2
inte_bevisar	neg	-2
inte_bevisat	neg	-2
inte_en_chans	neg	-2
inte_ensamt	pos	2
inte_fullt	pos	2
inte_fungerar	neg	-2
inte_förvånad	neg	-2
inte_förvånande	neg	-2
inte_godkänna	neg	-2
inte_godkänt	neg	-2
inte_håller_med	neg	-2
inte_imponerad	neg	-2
inte_lyda	neg	-2
inte_möjligt	neg	-2
inte_omöjligt	pos	2
inte_rekommenderas	neg	-2
inte_rekommenderats	neg	-2
inte_rädda	pos	2
inte_självklart	neg	-2
inte_säker	neg	-2
inte_säkra	neg	-2
intet_ont_anande	neg	-2
inte_tro	neg	-2
inte_utvecklat	neg	-2
inte_övertygad	neg	-2
i_olag	neg	-2
ironiskt_nog	neg	-2
i_sjunde_himlen	pos	2
i_strykklass	neg	-2
i_överflöd	pos	2
jesus_kristus	pos	2
jobba_hårt	pos	2
jobbat_hårt	pos	2
jobbigt_läge	neg	-2
jäkligt_bra	pos	2
jäkligt_glada	pos	2
jäkligt_skönt	pos	2
jämna_vägen	pos	2
jämra_sig	neg	-2
jävla_ansikte	neg	-2
jävla_beslutsångest	neg	-2
jävla_blåsta_människor	neg	-2
jävla_blåögd	neg	-2
jävla_bra	pos	2
jävla_dumheter	neg	-2
jävla_dumma	neg	-2
jävla_dåre	neg	-2
jävla_engagerad	pos	2
jävla_enkelt	pos	2
jävla_goda	pos	2
jävla_groteskt	neg	-2
jävla_hjälte	pos	2
jävla_hjärntvättad	neg	-2
jävla_huvud	neg	-2
jävla_idiot	neg	-2
jävla_jackpot	pos	2
jävla_kärringar	neg	-2
jävla_kärring	neg	-2
jävla_landet	neg	-2
jävla_less	neg	-2
jävla_loser	neg	-2
jävla_luffare	neg	-2
jävla_lättlurad	neg	-2
jävla_nolla	neg	-2
jävla_passande	pos	2
jävla_politiker	neg	-2
jävla_roliga	pos	1
jävla_sjuk	neg	-2
jävla_skit	neg	-2
jävla_skitsnack	neg	-2
jävla_stress	neg	-2
jävla_säker	pos	2
jävla_tjat	neg	-2
jävla_trams	neg	-2
jävla_troll	neg	-2
jävla_trötta	neg	-2
jävla_trött	neg	-2
jävla_tur	pos	2
jävla_tydligt	pos	2
jävla_underbart	pos	2
jävla_utvecklingsstört	neg	-2
jävla_vaccin	neg	-2
jävla_viktigt	pos	2
jävla_virus	neg	-2
jävla_ångest	neg	-2
jävla_åsikter	neg	-2
jävla_överdrift	neg	-2
jävligt_bra	pos	2
jävligt_dumt	neg	-2
jävligt_glada	pos	2
jävligt_lätt	pos	2
kalla_kårar	neg	-2
kan_erhållas	pos	2
kan_nås	pos	2
kan_uppgraderas	pos	2
kasta_bort	neg	-2
kastade_bort	neg	-2
kastas_överbord	neg	-2
kasta_ut_barnet_med_badvattnet	neg	-1
katastrofala_situationen	neg	-2
kikna_av_skratt	pos	2
kiknar_av_skratt	pos	2
klara_bevis	pos	2
klarar_sig	pos	2
klara_sig	pos	2
klema_bort	pos	2
klent_utrustad	neg	-2
klumpen_i_magen	neg	-2
knipa_käft	neg	-2
knip_käft	neg	-2
knäppa_av	pos	2
knäppa_på	pos	2
koka_upp	neg	-2
komma_hem	pos	2
komma_sig	pos	2
komma_till_pass	pos	2
komma_till_sin_rätt	pos	2
komma_åt	neg	-2
komma_överens	pos	2
kommer_hem	pos	2
kommer_sig	pos	2
kommer_till_sin_rätt	pos	2
kommer_överens	pos	2
kommit_överens	pos	2
kom_överens	pos	2
koncentrerar_sig	neg	-2
konstigt_nog	neg	-1
kortsiktig_lösning	neg	-2
kraftfulla_åtgärderna	pos	2
kraftfulla_åtgärder	pos	2
kraftfullt_ifrågasatt	neg	-2
kraftfullt_misskött	neg	-2
kraftfull_åtgärd	pos	2
kramar_sig	neg	-2
kritiska_kommentarer	pos	2
kritiska_synpunkter	pos	2
kritiska_åsikter	pos	2
kritisk_punkt	neg	-2
kritisk_situation	neg	-2
kritiskt_läge	neg	-2
kritiskt_skede	neg	-2
kritiskt_tillstånd	neg	-2
kritiskt_tänkande	pos	2
kritisk_tänkande	pos	2
kroniska_sjukdomar	neg	-2
kronisk_lungsjukdom	neg	-2
kronisk_sjuka	neg	-2
kroppsfrämmande_ämnen	neg	-2
kroppsliga_ingrepp	neg	-2
kryade_på_sig	pos	2
krya_på_sig	pos	2
krypa_till_korset	neg	-2
kryper_till_korset	neg	-2
kvicknar_till	pos	2
kvickna_till	pos	2
känna_empati	pos	2
känner_mig_sviken	neg	-2
känner_sig_sviken	neg	-2
känner_sig_så_svikna	neg	-2
känns_lite_sådär	neg	-2
känns_sådär	neg	-2
käppar_i_hjulet	neg	-2
kära_lilla_du	neg	-2
köra_om	pos	2
lallar_omkring	neg	-2
legat_nere	neg	-2
le_i_mjugg	pos	2
ler_i_mjugg	pos	2
leva_upp	pos	2
leva_ut	pos	2
lever_upp	pos	2
lever_ut	pos	2
lidande_person	neg	-2
ligga_lågt	pos	2
ligger_risigt_till	neg	-2
lik_förbannat	neg	-2
lita_blint	neg	-1
litar_blint	neg	-1
litar_på	pos	2
lite_feber	pos	1
lite_för_styrda	neg	-2
lite_kunskap	neg	-1
liten_chans	neg	-1
liten_risk	pos	1
lite_resurser	neg	-1
lite_skum	neg	-1
litet_bekymmer	pos	1
litet_glädjebesked	pos	2
litet_glädjeämne	pos	2
lite_underlag	neg	-1
lite_väl_mycket	neg	-2
lite_värk	pos	1
liva_upp	pos	2
liv_skördades	neg	-2
ljusa_upp	pos	2
ljuset_i_mörkret	pos	2
locka_till_sig	pos	2
lorta_ner	neg	-2
lost_i_skallen	neg	-2
lugna_ner_sig	pos	2
lura_sig	neg	-2
lyckades_lura	neg	-2
lyckades_utrota	pos	2
lyckas_lura	neg	-2
lyckas_utrota	pos	2
lyckas_vända	pos	2
lycka_till	pos	2
lyckats_lura	neg	-2
lyckats_undvika	pos	2
lyckats_utrota	pos	2
lycka_utrota	pos	2
lycklig_lottad	pos	2
lyckligt_lottade	pos	2
lyckligt_lottad	pos	2
lyfta_sig	pos	2
lysa_skarpt	neg	-2
lysa_upp	pos	2
lyser_upp	pos	2
låg_dödlighet	neg	-2
låg_dödlighet	pos	1
låg_funktionsförmåga	neg	-2
låg_intelligens	neg	-2
låg_kostnad	pos	2
låg_motivation	neg	-2
låg_risk	pos	2
lågt_medvetande	neg	-2
lågt_pris	pos	2
långdragna_besvär	neg	-2
långsiktiga_bieffekter	neg	-2
långsiktiga_biverkningarna	neg	-2
långsiktiga_biverkningar	neg	-2
långsiktiga_konsekvenserna	neg	-2
långsiktiga_konsekvenser	neg	-2
långsiktiga_problem	neg	-2
långsiktig_bieffekter	neg	-2
långsiktig_biverkning	neg	-2
långsiktig_negativ	neg	-2
lång_tid	neg	-1
långvariga_besvär	neg	-2
långvariga_hälsoproblem	neg	-2
långvarig_biverkning	neg	-2
långvarig_forskning	pos	2
långvarigt_skydd	pos	2
låta_nåd_gå_före_rätt	pos	2
låta_sig_nöja	pos	2
låta_udda_vara_jämnt	pos	2
låta_udda_vara_jämt	pos	2
låter_sig_nöja	pos	2
låter_sådär	neg	-2
läcka_ut	neg	-2
läcker_ut	neg	-2
lägre_dödlighet	pos	1
lämplig_källa	pos	2
läsa_in	pos	2
läser_in	pos	2
läskigt_bra	pos	3
lätt_att_använda	pos	2
lätt_att_bli_andfådd	neg	-2
lätt_att_glömma	neg	-2
lätt_att_lura	neg	-2
lätt_att_missa	neg	-2
lätt_att_misslyckas	neg	-2
lätt_för_att_gråta	neg	-1
lätt_som_en_plätt	pos	3
läxa_upp	neg	-2
löjla_sig	pos	2
löna_sig	pos	2
lösa_grunder	neg	-2
lösa_in	pos	2
lösryckta_fakta	neg	-2
löst_in	pos	2
mark_of_the_beast	neg	-3
massa_skit	neg	-2
med_armarna_i_kors	neg	-1
med_eftertryck	neg	-2
medelmåttig_intelligens	neg	-2
med_fördel	pos	2
med_hull_och_hår	neg	-1
medicinsk_bedömning	pos	2
medicinsk_bomb	pos	2
med_nöd_och_näppe	neg	-1
med_respekt	pos	2
med_rätta	pos	2
med_vinst	pos	2
med_öppna_armar	pos	2
men_för_livet	neg	-2
meningslösa_dravel	neg	-2
mental_förnedring	neg	-2
mental_ohälsa	neg	-2
mentalt_kuvade	neg	-2
mental_ångest	neg	-2
milda_symptom	pos	1
milda_symtom	pos	2
mindre_allvarliga_konsekvenser	pos	1
mindre_allvarliga	pos	1
mindre_allvarligt	pos	1
mindre_begåvade	neg	-1
mindre_betydelse	neg	-1
mindre_biverkning	neg	-1
mindre_chans	neg	-1
mindre_drabbad	pos	1
mindre_dödliga	pos	1
mindre_dödlighet	pos	1
mindre_dödligt	pos	1
mindre_effektiva	neg	-1
mindre_effektivt	neg	-1
mindre_farlig	pos	1
mindre_farligt	pos	1
mindre_fördelaktigt	neg	-1
mindre_lyckad	neg	-1
mindre_mottaglig	neg	-1
mindre_nogräknat	pos	1
mindre_omöjligt	pos	1
mindre_oroligheter	pos	1
mindre_paria	pos	1
mindre_pinsamt	pos	1
mindre_positiva	neg	-2
mindre_påtvinga	pos	1
mindre_risk	pos	1
mindre_sjuk	pos	1
mindre_smittad	pos	1
mindre_smittsam	pos	1
mindre_smittspridning	pos	1
mindre_snömos	pos	1
mindre_trött	pos	1
mindre_tvingade	pos	1
mindre_tvingat	pos	1
mindre_tvungen	pos	1
mindre_tvång	pos	1
mindre_verkningslösa	pos	1
mindre_vetenskapligt	neg	-1
mindre_värda	neg	-1
mindre_värd	neg	-1
mindre_värt	neg	-1
mindre_äckligt	pos	1
mindre_överraskning	pos	1
minimala_fuskmöjligheter	neg	-1
minimal_ansträngning	pos	2
minimal_belastning	pos	2
minimal_förbättring	neg	-1
minimal_försämring	neg	-1
minimal_påverkan	pos	2
minimal_risk	pos	2
minimalt_invasiv	neg	-1
minimalt_skydd	neg	-2
minimal_överdödlighet	neg	-1
minska_intaget	pos	1
minska_miljöpåverkan	pos	2
minskar_föroreningar	pos	1
minska_risken	pos	2
minska_risk	pos	2
minska_smittspridningen	pos	2
minska_smittspridning	pos	2
minska_symptomen	pos	2
minska_symptom	pos	2
minska_symtomen	pos	2
minska_symtom	pos	2
minskat_barnafödande	neg	-2
misstänkt_biverkning	neg	-2
mitt_i_prick	pos	2
mitt_i_smeten	pos	2
mjölkas_pengar	neg	-2
monetära_systemet	neg	-1
moppsa_upp	neg	-1
moraliskt_fel	neg	-2
moraliskt_förkastlig	neg	-2
mot_min_vilja	neg	-2
mot_sin_vilja	neg	-3
multisjuka_äldre	neg	-2
muntra_opp	pos	2
muntra_upp	pos	2
mycket_bra	pos	2
mycket_dåligt	neg	-2
mycket_farligt	neg	-2
mycket_frikostigt	pos	2
mycket_god	pos	2
mycket_intryck	pos	2
mycket_liten	neg	-2
mycket_liten_risk	pos	2
mycket_lång_tid	neg	-1
mycket_nytta	pos	2
mycket_nyttigt	pos	2
mycket_oroliga	neg	-2
mycket_sjuka	neg	-2
mycket_sjukare	neg	-2
mycket_sjuk	neg	-2
mycket_sköra	neg	-2
mycket_större_risk	neg	-3
mycket_tragiskt	neg	-2
mycket_tungt	neg	-2
måla_fan_på_väggen	neg	-2
må_som_en_prins	pos	2
märkligt_nog	neg	-2
märkt_av_döden	neg	-2
möjlig_biverkning	neg	-1
möjlig_biverkning	neg	-2
möjligt_konstigt	neg	-2
mörkare_krafter	neg	-2
mörkare_motiv	neg	-2
mörk_i_sinnet	neg	-2
naggande_god	pos	2
naggande_gott	pos	2
naiv_korkad	neg	-2
naturlig_immunitet	pos	2
naturlig_infektion	neg	-2
nedlåta_sig	neg	-2
nedsatt_hälsa	neg	-2
negativa_effekterna	neg	-2
negativa_effekter	neg	-2
negativa_konsekvenserna	neg	-2
negativa_konsekvenser	neg	-2
negativa_långtidseffekter	neg	-2
negativa_testresultat	pos	2
negativa_vibbar	neg	-2
negativ_effekt	neg	-2
negativ_klang	neg	-2
negativ_syn	neg	-2
negativt_antikroppstest	pos	2
negativt_corona	pos	2
negativt_coronatest	pos	2
negativt_corona-testresultat	pos	2
negativt_covid-19	pos	2
negativt_covid-19-prov	pos	2
negativt_covid-19-test	pos	2
negativt_covid	pos	2
negativt_covid-prov	pos	2
negativt_covid-test	pos	2
negativt_covidtest	pos	2
negativt_pcr-resultat	pos	2
negativt_pcr-svar	pos	2
negativt_pcr-test	pos	2
negativt_pcr-virustest	pos	2
negativt_provsvar	pos	2
negativt_rekord	neg	-2
negativt_testresultat	pos	2
negativt_virustest	pos	2
nej_tack	neg	-2
nemas_problemas	pos	2
new_world_order	neg	-2
njuta_av	pos	2
njut_av	pos	2
njuter_av	pos	2
nog_bra	pos	2
nog_bäst	pos	2
nog_möjligt	pos	2
noll_bekymmer	pos	2
noll_förtroende	neg	-2
nya_biverkningarna	neg	-2
nya_biverkningar	neg	-2
nya_blåmärken	neg	-2
nya_cancerfall	neg	-2
nya_covid-varianter	pos	2
nya_digerdöden	neg	-2
nya_dödsfall	neg	-2
nya_ideal	pos	2
nya_influensavaccinet	pos	2
nya_kunskapen	pos	1
nya_läkemedel	pos	2
nya_mediciner	pos	2
nya_mutationen	neg	-2
nya_mutationerna	neg	-2
nya_mutationer	neg	-2
nya_mutation	neg	-2
nya_muterade	neg	-2
nya_preparat	pos	2
nya_problem	neg	-2
nya_restriktioner	neg	-2
nya_risker	pos	2
nya_rön	pos	2
nya_sjukdomar	neg	-2
nya_skitsamhälle	neg	-2
nya_superspridarna	pos	2
nya_tramset	pos	2
nya_trassel	neg	-2
nya_vaccinerna	pos	2
nya_vacciner	pos	2
nya_viruset	neg	-2
nya_virusmutationer	neg	-2
nya_virus	neg	-2
nya_virusstammar	pos	2
nya_virusutbrott	neg	-2
nya_virusvarianterna	pos	2
nya_virusvarianter	neg	-2
nya_världsordningen	neg	-2
nya_världsordning	neg	-2
ny_bedrägerivåg	neg	-2
ny_biverkning	neg	-2
ny_dubbelmutation	neg	-2
ny_fascistisk	neg	-2
ny_forskning	pos	2
ny_kunskap	pos	1
ny_mutation	neg	-2
ny_nedstängning	neg	-2
ny_teknologi	pos	2
nyttig_läxa	pos	2
nytt_oprövat	neg	-2
nytt_virus	neg	-2
ny_utbrott	neg	-2
ny_virusmutation	neg	-2
ny_virusstam	neg	-2
ny_virusvariant	neg	-2
nära_bristningsgränsen	neg	-2
nära_kollaps	neg	-2
nära_och_kära	pos	1
nära_och_kära	pos	2
nära_samarbete	pos	2
nära_samverkan	pos	2
nära_varandra	pos	2
nöja_sig	pos	2
obefintlig_risk	pos	2
obelagda_fantasier	neg	-2
obetydliga_besvär	pos	2
obetydliga_symptom	pos	2
obildbara_antivaxxers	neg	-2
oerhört_ansträngt	neg	-3
oerhört_beroende	neg	-3
oerhört_hårt	neg	-3
oerhört_lång_tid	neg	-2
oerhört_lättad	pos	3
oerhört_rabiat	neg	-2
oerhört_resurskrävande	neg	-3
oerhört_svåra	neg	-3
oerhört_svår	neg	-3
oerhört_svårt	neg	-3
oerhört_värde	pos	3
ofarlig_sjukdom	pos	2
ofarligt_virus	neg	-2
ofattbart_idiotiskt	neg	-2
oförmåga_att_förstå	neg	-2
oförskämt_lätt	pos	2
ogift_kvinna	neg	-2
ohälsosamma_levnadsvanor	neg	-2
ojust_spel	neg	-2
ok_källa	pos	2
olycklig_kärlek	neg	-2
olyckligt_nog	neg	-2
omfattande_konsekvenser	neg	-2
omfattande_nedstängningar	neg	-2
omfattande_nedstängning	neg	-2
omfattande_restriktioner	neg	-2
omfattande_samhällsspridningen	neg	-2
omfattande_samhällsspridning	neg	-2
omfattande_skador	neg	-2
omfattande_smitta	neg	-2
omfattande_smittspridningen	neg	-2
omfattande_smittspridning	neg	-2
omfattande_spridningen	neg	-2
omfattande_spridning	neg	-2
omfattande_stängning	neg	-2
omfattande_underrapportering	neg	-2
omöjlig_att_skilja	neg	-2
omöjlig_att_stoppa	neg	-2
omöjlig_att_stoppa	pos	2
onda_krafter	neg	-2
ond_cirkel	neg	-2
onyttigt_skräp	neg	-2
operera_in	pos	2
orimliga_anställningsvillkor	neg	-2
orimliga_arbetsvillkor	neg	-2
orimliga_dödssiffror	neg	-2
orimliga_förhållanden	neg	-2
orimliga_rädsla	neg	-2
orimligt_dyra	neg	-2
orimligt_långa_väntetider	neg	-2
orimligt_lång_tid	neg	-2
oroväckande_nog	neg	-2
oroväckande_resultat	neg	-2
osäker_grund	neg	-2
otroligt_sargat	neg	-2
otrygg_grund	neg	-2
oturligt_nog	neg	-2
otydliga_direktiv	neg	-2
ovanlig_biverkning	neg	-2
ovanligt_bra	pos	2
ovanligt_känslotyngt	neg	-2
ovetenskapliga_föreställningar	neg	-2
pappa_staten	neg	-1
paradoxalt_nog	neg	-2
passa_ihop	pos	2
passa_in	pos	2
passa_samman	pos	2
pengar_tillbaka	pos	2
personlig_vinning	pos	1
pigga_opp	pos	2
pigga_upp	pos	2
piggnar_till	pos	2
piggna_till	pos	2
pirret_i_magen	pos	2
pirr_i_magen	pos	2
piska_upp	neg	-2
platta_ut	neg	-2
plocka_fram	pos	2
plockar_fram	pos	2
plågsamt_naiv	neg	-2
plågsamt_sätt	neg	-2
politisk_bluff	neg	-1
politiskt_korrekt	pos	2
politiskt_självmord	neg	-2
politiskt_våld	neg	-2
poppar_champagne	pos	2
positiva_effekterna	pos	2
positiva_effekter	pos	2
positiva_tecken	pos	2
positiv_effekt	pos	2
pressad_sjukvård	neg	-3
pressa_ut	neg	-2
problem_i_äldreomsorgen	neg	-2
psykisk_kolaps	neg	-2
psykisk_ohälsa	neg	-2
psykisk_sjukdom	neg	-2
på_avstånd	neg	-2
på_bättringsväg	pos	2
på_hal_is	neg	-2
pålitlig_källa	pos	2
på_nytt_bekräfta	pos	2
på_tomgång	neg	-2
på_topp	pos	2
ramlade_ihop	neg	-2
ramla_ut	neg	-2
rasande_fart	pos	1
reda_ut	neg	-2
redigt_ont	neg	-2
rejäl_smäll	neg	-2
rejäl_spridning	neg	-2
relativt_bra	pos	2
rena_döden	neg	-2
rena_giftet	neg	-2
ren_bacillskräck	neg	-2
ren_bluff	neg	-2
ren_desinformation	neg	-2
ren_desinformationskampanj	neg	-2
ren_diktatur	neg	-2
ren_dumhet	neg	-2
ren_egoist	neg	-2
ren_fattigdom	neg	-2
ren_foliehatt-mentalitet	neg	-2
ren_galenskap	neg	-2
ren_idioti	neg	-2
ren_idiot	neg	-2
ren_illvilja	neg	-2
ren_ilska	neg	-2
ren_jävla	neg	-2
ren_katastrof	neg	-2
ren_krigshandling	neg	-2
ren_kriminalitet	neg	-2
ren_lögn	neg	-2
ren_misär	neg	-2
ren_motvilja	neg	-2
ren_nazism	neg	-2
ren_nervgift	neg	-2
ren_nonsens	neg	-2
ren_omöjlighet	neg	-2
ren_ondska	neg	-2
ren_panik	neg	-2
ren_paranoia	neg	-2
ren_propaganda	neg	-2
ren_skam	neg	-2
ren_skit	neg	-2
ren_skrämsel	neg	-2
ren_skrämselpropaganda	neg	-2
ren_smörja	neg	-2
ren_spekulation	neg	-2
rent_av_deprimerad	neg	-2
rent_av_falska	neg	-2
rent_av_farligt	neg	-2
rent_blåljug	neg	-2
rent_djävulskt	neg	-2
rent_egoistiska	neg	-2
rent_faktafel	neg	-2
rent_felaktig	neg	-2
rent_hjärnspöke	neg	-2
rent_hyckleri	neg	-2
rent_hälsofarligt	neg	-2
rent_krasst	neg	-2
rent_kriminellt	neg	-2
rent_landsförräderi	neg	-2
rent_livrädd	neg	-2
rent_nonsens	neg	-2
rent_påhitt	neg	-2
rent_slöseri	neg	-2
rent_tok	neg	-2
ren_utpressning	neg	-2
ren_vetenskapsbluff	neg	-2
resa_bort	pos	2
reser_bort	pos	2
riktiga_problemet	neg	-2
riktig_byfåne	neg	-2
riktig_influensa	neg	-2
riktig_källa	pos	2
riktig_otur	neg	-2
riktigt_allvarliga	neg	-2
riktigt_bekymrad	neg	-2
riktigt_besviken	neg	-2
riktigt_besvärligt	neg	-2
riktigt_brant	neg	-2
riktigt_bra	pos	2
riktigt_dåliga	neg	-2
riktigt_dålig	neg	-2
riktigt_dåligt	neg	-2
riktigt_efterbliven	neg	-2
riktigt_farlig	neg	-2
riktigt_fina	pos	2
riktigt_friska	pos	2
riktigt_fult	neg	-2
riktigt_förbannad	neg	-2
riktigt_galet	neg	-2
riktigt_goda	pos	2
riktigt_gott	pos	2
riktigt_gött	pos	2
riktigt_harmonierade	pos	2
riktigt_hemska	neg	-2
riktigt_häftig	pos	2
riktigt_häftigt	pos	2
riktigt_illa	neg	-2
riktigt_jobbiga	neg	-2
riktigt_jobbig	neg	-2
riktigt_jobbigt	neg	-2
riktigt_korkat	neg	-2
riktigt_kul	pos	2
riktigt_kämpigt	neg	-2
riktigt_ledsamt	neg	-2
riktigt_lovande	pos	2
riktigt_läskigt	neg	-2
riktigt_lömsk	neg	-2
riktigt_mysig	pos	2
riktigt_obehagligt	neg	-2
riktigt_oberoende	neg	-2
riktigt_olycklig	neg	-2
riktigt_ont	neg	-2
riktigt_oroad	neg	-2
riktigt_orolig	neg	-2
riktigt_oroväckande	neg	-2
riktigt_osmakligt	neg	-2
riktigt_overkligt	neg	-2
riktigt_petig	neg	-2
riktigt_rädd	neg	-2
riktigt_rätt	pos	2
riktigt_sjuka	neg	-2
riktigt_sjuk	neg	-2
riktigt_skicklig	pos	2
riktigt_skräckscenario	neg	-2
riktigt_skrämmande	neg	-2
riktigt_sköra	neg	-2
riktigt_sköra_äldre	neg	-2
riktigt_smutsiga	neg	-2
riktigt_snett	neg	-2
riktigt_stressiga	neg	-2
riktigt_sunt	pos	2
riktigt_surt	neg	-2
riktigt_svåra	neg	-2
riktigt_svår	neg	-2
riktigt_svårt	neg	-2
riktigt_tragiskt	neg	-2
riktigt_tråkigt	neg	-2
riktigt_tuffa	neg	-2
riktigt_tufft	neg	-2
riktigt_tung	neg	-2
riktigt_tungt	neg	-2
riktigt_turbulent	neg	-2
riktigt_upprörd	neg	-2
riktigt_usla	neg	-2
riktigt_äckligt	neg	-2
risky_business	neg	-1
rista_blodsörn	neg	-2
rista_blodörn	neg	-2
riva_upp	neg	-2
roar_sig	pos	2
roa_sig	pos	2
rubbat_luktsinne	neg	-2
rusar_i_höjden	pos	2
ruskigt_snabba	pos	3
rustade_ner	neg	-2
rusta_ner	neg	-2
rusta_opp	pos	2
rustar_ner	neg	-2
rustat_ner	neg	-2
rusta_upp	pos	2
rycka_på_axlarna	neg	-2
rycka_upp	pos	2
rycka_upp_sig	pos	2
rycker_upp	pos	2
rygga_tillbaka	neg	-2
rynka_pannan	neg	-2
rynkar_pannan	neg	-2
rysk_roulette	neg	-2
rysk_roulett	neg	-2
räta_ut	pos	2
rätta_till	pos	2
rätt_beslut	pos	2
rätt_ok	pos	2
rätt_riktning	pos	2
rätt_spår	pos	2
rätt_strategi	pos	2
rätt_sugen	pos	2
röda_hund	neg	-2
röd_av_ilska	neg	-2
sade_upp_sig	neg	-2
saknar_betydelse	neg	-2
saknar_botemedel	neg	-2
saknar_empati	neg	-2
saknar_evidens	neg	-2
saknar_frihet	neg	-2
saknar_förmåga	neg	-2
saknar_förmågan	neg	-2
saknar_förståelse	neg	-2
saknar_förtroende	neg	-2
saknar_grund	neg	-2
saknar_kompetens	neg	-2
saknar_kreativitet	neg	-2
saknar_kunskap	neg	-2
saknar_resurser	neg	-2
saknar_solidaritet	neg	-2
saknar_stöd	neg	-2
saknar_sympati	neg	-2
saknar_tankeförmåga	neg	-2
saknar_tillgång	neg	-2
saknar_transparens	neg	-2
saknar_trovärdighet	neg	-2
saknar_värde	neg	-2
saktade_ner	neg	-2
sakta_ner	pos	2
samhällets_mest_utsatta	neg	-2
samla_ihop	pos	2
satanisk_plan	neg	-2
sataniskt	neg	-2
satanistiska_barnamord	neg	-2
satans_tvärsäker	neg	-2
satsar_för_fullt	pos	2
se_genom_fingrarna	pos	2
se_ned	neg	-2
se_upp	pos	2
sexuella_närmanden	neg	-2
sexuellt_överförbar	neg	-2
shut_up	neg	-2
sitta_bra	pos	2
sitta_fint	pos	2
sitta_inne	neg	-2
sjuka_konspirationsvärld	neg	-2
sjukdomar_utrotats	pos	2
sjukt_bra	pos	2
sjukt_bra	pos	3
sjukt_goa	pos	3
sjukt_viktigt	pos	2
sjunker_risken	pos	2
sju_resor_värre	neg	-2
skar_ned	neg	-2
skar_ner	neg	-2
skinande_rent	pos	2
skiter_fullständig	neg	-2
skiter_fullständigt	neg	-2
skjuta_i_sig	neg	-2
skjuta_upp	neg	-2
skjuta_över_målet	neg	-2
skjuter_upp	neg	-2
skjutits_upp	neg	-2
skrattretande_dumt	neg	-2
skruvade_upp	neg	-2
skruvar_lösa	neg	-2
skruva_upp	neg	-2
skrämma_bort	neg	-2
skrämmande_nog	neg	-2
skrämmande_resultat	neg	-2
skrämma_upp	neg	-2
skrämt_upp	neg	-2
skuldsättning	neg	-2
skum_artikel	neg	-2
skyddande_effekt	pos	2
skylla_på	neg	-2
skällde_ut	neg	-2
skämma_bort	neg	-2
skämmer_bort	pos	2
skära_i_ögonen	neg	-2
skära_ned	neg	-2
skära_ner	neg	-2
skära_sig	neg	-2
skärpa_sig	pos	2
skön_träningsvärk	pos	2
sköraste_äldre	neg	-2
sköra_äldre	neg	-2
skörda_allt_fler_liv	neg	-2
skördade_allt_fler_liv	neg	-2
skördade_flera_liv	neg	-2
skördade_fler_liv	neg	-2
skördade_liv	neg	-2
skördade_många_liv	neg	-2
skördade_många_människors_liv	neg	-2
skörda_fler_liv	neg	-2
skörda_liv	neg	-2
skörda_många_liv	neg	-2
skördar_allt_fler_liv	neg	-2
skördar_fler_liv	neg	-2
skördar_liv	neg	-2
skördar_mest_liv	neg	-2
skördar_många_liv	neg	-2
skördat_allt_fler_liv	neg	-2
skördat_fler_liv	neg	-2
skördat_liv	neg	-2
skördat_många_liv	neg	-2
slagit_hårt	neg	-2
slappna_av	pos	2
slappnar_av	pos	2
slita_sönder	neg	-2
slog_hårt	neg	-2
slå_dank	neg	-2
slå_hårt	neg	-2
slå_ihjäl	neg	-2
slå_klackarna_i_taket	pos	2
slå_med_häpnad	pos	2
slå_ned_modet	neg	-2
slå_på_fingrarna	pos	2
slår_hårt	neg	-2
slår_ihjäl	neg	-2
slår_sönder	neg	-2
slår_ut_viruset	pos	2
slå_sig_till_ro	pos	2
slå_sönder	neg	-2
slå_tillbaka	neg	-2
slå_ut_viruset	pos	2
slå_väl_ut	pos	2
släppa_gäcken_lös	pos	2
släppa_igenom	pos	2
släppta_restriktioner	pos	2
slösa_bort	neg	-2
smitta_ned	neg	-2
smitta_ner	neg	-2
smittar_ner	neg	-2
smittat_blod	neg	-2
smula_ner	neg	-2
smyga_sig_in	neg	-2
smyger_sig_in	neg	-2
små_biverkningar	pos	1
smälta_in	pos	2
snabbast_växande	pos	2
snabbt_på_banan	pos	2
snabbt_växande	pos	2
snuva_ned	neg	-2
snygga_till	pos	2
snygga_upp	pos	2
snälla_du	neg	-1
sociala_distanseringen	neg	-2
social_aktivitet	pos	2
sociala_sammanhanget	pos	2
sociala_sammanhang	pos	2
social_distancing	neg	-2
social_distansering	neg	-2
social_distans	neg	-2
social_fobi	neg	-2
social_gemenskap	pos	2
social_isolering	neg	-2
social_kontroll	neg	-2
social_ojämlikhet	neg	-2
social_stigmatisering	neg	-2
socialt_sammanhang	pos	2
socialt_umgänge	pos	2
social_utsatthet	neg	-2
socker_lager	neg	-2
som_en_öppen_bok	pos	2
som_tur_är	pos	2
som_är_änka	neg	-2
sorgligt_nog	neg	-2
sosse_diktatur	neg	-2
spamma_ner	neg	-2
spanska_sjukan	neg	-2
spanska_sjukans	neg	-2
sparka_arsel	pos	2
sparka_röv	pos	2
spela_in	pos	2
spelar_upp	pos	2
spela_upp	pos	2
spola_ned	pos	2
spola_ner	pos	2
springa_fram	neg	-2
springa_in	neg	-2
spring_iväg	neg	-2
spring_ner	neg	-2
spränga_banken	pos	2
spårade_av	neg	-2
spårar_av	neg	-2
spåra_ur	neg	-2
spårlöst_borta	neg	-2
spårlöst_försvunnen	neg	-2
stabilt_dåligt	neg	-2
stapla_upp	neg	-2
starka_biverkningar	neg	-2
starka_bokslutsrapporter	pos	2
starka_ekonomiska_intressen	neg	-2
starka_förhoppning	pos	2
starka_immunsvar	pos	2
starka_intryck	pos	2
starka_ledare	pos	2
starka_positiva	pos	2
starka_reaktioner	pos	2
starkare_immunitet	pos	2
starkare_skydd	pos	2
starka_restriktioner	neg	-2
starka_statsfinanser	pos	2
starkaste_ordalag	neg	-1
starkast_intryck	pos	2
stark_kritik	neg	-2
stark_press	neg	-2
stark_sammanhållning	pos	2
starkt_avskräckande	neg	-2
starkt_engagemang	pos	2
starkt_försvar	pos	2
starkt_fötroende	pos	2
starkt_immunförsvar	pos	2
starkt_immunsvar	pos	2
starkt_intryck	pos	2
starkt_kritiska	neg	-2
starkt_kritisk	neg	-2
starkt_positiv	pos	2
starkt_skydd	pos	2
starkt_stöd	pos	2
stoppade_smitta	pos	2
stoppa_smitta	pos	2
stoppa_smittspridningen	pos	2
stora_brister	neg	-2
stor_belastning	neg	-2
stor_brist	neg	-2
stor_erfarenhet	pos	2
stor_framgång	pos	2
stor_frustration	neg	-2
stor_fördel	pos	2
stor_förvirring	neg	-2
stor_hjälp	pos	2
stor_kapacitet	pos	2
stor_kostnad	neg	-2
stor_kritik	neg	-2
stor_kränkning	neg	-2
stor_möjlighet	pos	2
stor_nytta	pos	2
stor_och_tung	neg	-2
stor_oro	neg	-2
stor_osäkerhet	neg	-2
stor_potential	pos	2
stor_press	neg	-2
stor_påfrestning	neg	-2
stor_risken	neg	-2
stor_risk	neg	-2
stor_samhällsspridning	neg	-2
stor_skada	neg	-2
stor_skandal	neg	-2
stor_smitta	neg	-2
stor_smittspridningen	neg	-2
stor_smittspridning	neg	-2
stor_sorg	neg	-2
stor_säkerhet	pos	2
stort_allvar	pos	2
stort_ansvar	pos	2
stor_tilltro	pos	2
stort_lass	neg	-1
stort_mörkertal	neg	-2
stor_trängsel	neg	-2
stor_vana	pos	2
stor_vilja	pos	2
stor_virusspridning	neg	-2
stor_vårdskuld	neg	-2
stressades_fram	neg	-2
stressa_fram	neg	-2
stressa_upp_sig	neg	-2
strider_mot	neg	-2
strunta_i	neg	-2
strålande_humör	pos	2
sträcka_på_sig	pos	2
sträcker_sig	pos	2
strängare_restriktioner	neg	-2
styra_människor	neg	-2
stå_emot	pos	2
stå_still	neg	-2
stå_ut	pos	2
städa_undan	pos	2
ställa_till_rätta	pos	2
stänka_ner	neg	-2
stödjer_inte	neg	-2
större_ansvar	pos	2
större_bekymmer	neg	-2
större_chans	pos	2
större_effekt	pos	2
större_frihet	pos	2
större_förtroende	pos	2
större_hot	neg	-2
större_immunitet	pos	2
större_inskränkningar	neg	-2
större_intresse	pos	2
större_intryck	pos	2
större_kaos	neg	-2
större_klyftor	neg	-2
större_konsekvenser	neg	-2
större_kris	neg	-2
större_marginal	pos	2
större_misstro	neg	-2
större_motstånd	neg	-2
större_mörkertal	neg	-2
större_nedgångar	neg	-2
större_nedgång	neg	-2
större_nytta	pos	2
större_nöd	neg	-2
större_olycka	neg	-2
större_operation	neg	-2
större_oro	neg	-2
större_polarisering	neg	-2
större_problem	neg	-2
större_påfrestningar	neg	-2
större_påfrestning	neg	-2
större_påverkan	neg	-2
större_restriktioner	neg	-2
större_risker	neg	-2
större_risk	neg	-2
större_skada	neg	-2
större_skydd	pos	2
större_smitta	neg	-2
större_smittspridning	neg	-2
större_stöd	pos	2
större_tilltro	pos	2
större_transparens	pos	2
större_trygghet	pos	2
större_trängsel	neg	-2
större_utbrott	neg	-2
större_ödmjukhet	pos	2
största_företagsskandalerna	neg	-2
största_skandalen	neg	-2
största_skandalerna	neg	-2
största_skandaler	neg	-2
störst_risk	neg	-2
suddar_ut	neg	-2
sunda_förnuftet	pos	2
sund_skepsis	pos	2
svagare_resultat	neg	-2
svagt_nedåt	neg	-1
svagt_positiv	pos	1
svagt_positivt	pos	1
svarta_börsen	neg	-2
svarta_döden	neg	-2
svarta_marknaden	neg	-2
svart_i_synen	neg	-2
svimma	neg	-2
svimmar	neg	-2
svåra_konsekvenser	neg	-2
svårare_konsekvenser	neg	-2
svår_biverkning	neg	-2
svår_situation	neg	-2
svårt_att_acceptera	neg	-2
svårt_att_andas	neg	-2
svårt_att_bevisa	neg	-2
svårt_att_förklara	neg	-2
svårt_att_förstå	neg	-2
svårt_att_motivera	neg	-2
svårt_att_sova	neg	-2
svårt_att_svälja	neg	-2
svårt_att_uppdatera	neg	-2
svårt_att_uppnå	neg	-2
svårt_covidsjuka	neg	-2
svårt_covidsjuka_äldre	neg	-2
svårt_funktionsnedsatta	neg	-2
svårt_nog	neg	-2
svårt_problem	neg	-2
svårt_sjuka	neg	-2
svårt_sjuk	neg	-2
svårt_utbrott	neg	-2
svårt_utsatt	neg	-2
svälta_ut	neg	-2
svärta_ner	neg	-2
symptomfria_äldre	pos	2
synlig_katastrof	neg	-2
så_fan_heller	neg	-2
så_in_i_helvete	neg	-2
så_kal	neg	-2
så_svikna	neg	-2
sämre_effekt	neg	-2
sämre_förutsättningar	neg	-2
sämre_läge	neg	-2
sämre_möjlighet	neg	-2
sämre_prognos	neg	-2
sämre_rustade	neg	-2
sämre_rustad	neg	-2
sämre_skydd	neg	-2
sämre_utfall	neg	-2
sämre_utveckling	neg	-2
sämsta_sort	neg	-2
sämst_nog	neg	-2
särskilt_intressant	pos	1
särskilt_svårt	neg	-2
särskilt_tragiskt	neg	-2
särskilt_uppmuntrande	pos	2
särskilt_utsatta	neg	-2
särskilt_utsatt	neg	-2
särskilt_utsatt_riskgrupp	neg	-2
sätta_dit	neg	-2
sätta_i_halsen	neg	-2
ta_av_sig	pos	2
tackade_nej	neg	-2
tacka_nej	neg	-2
tackar_nej	neg	-2
tack_men_nej_tack	neg	-2
tack_och_lov	pos	2
tack_vare	pos	2
tack_å_lov	pos	2
ta_emot	pos	2
ta_fram	pos	2
tagit_kål_på	neg	-2
ta_igen_sig	pos	2
tala_sanning	pos	2
tala_väl	pos	2
tappa_bort	neg	-2
tappa_modet	neg	-2
tappar_bort	neg	-2
tappas_bort	neg	-2
tappat_bort	neg	-2
tappats_bort	neg	-2
tar_fram	pos	2
tar_illa_upp	neg	-2
tar_sig_i_brasan	neg	-2
tar_sig_i_röven	neg	-2
tar_slut	neg	-2
tar_över	pos	2
ta_sig_an	pos	1
ta_sig_där_bak	neg	-2
ta_sig_i_arschlet	neg	-2
ta_sig_i_arslet	neg	-2
ta_sig_i_brasan	neg	-2
ta_sig_i_röven	neg	-2
ta_sig	pos	2
ta_sig_uppåt	pos	2
taskigt_beteende	neg	-2
ta_slut	neg	-2
ta_tillbaka	neg	-2
ta_till_lipen	neg	-2
ta_till_nåder	pos	2
ta_väldigt_illa_vid	neg	-2
tekniskt_fel	neg	-2
tekniskt_obevandrade	neg	-2
testat_negativt	pos	2
testat_positivt	neg	-2
testats_negativt	pos	2
testats_positivt	neg	-2
<thumbs-down>	neg	-2
<thumbs-up>	pos	2
till_lags	pos	2
tillräcklig_kunskap	pos	2
tillräckligt_bra	pos	2
tillräckligt_effektivt	pos	2
tillräckligt_god	pos	2
tillräckligt_gott	pos	2
tillräckligt_illa	neg	-1
tillräckligt_skydd	pos	2
tillräckligt_stöd	pos	2
tillräckligt_säkert	pos	2
tillräckligt_tillförlitliga	pos	2
tillskansa_sig	neg	-2
tilltagande_smittspridning	neg	-2
tjäna_in	neg	-2
tomma_ord	neg	-1
tomtar_på_loftet	neg	-2
tonade_ned	neg	-1
tona_ned	neg	-1
tonar_ned	neg	-1
tragiska_konsekvenserna	neg	-2
tragiska_konsekvenser	neg	-2
tragisk_milstolpe	neg	-2
tragiskt_nog	neg	-2
trampa_ner	neg	-2
tramsiga_vaccinationsmotståndet	neg	-2
trassla_in	neg	-2
trilla_av	neg	-2
trilla_ner	neg	-2
trillar_av	neg	-2
trillar_ner	neg	-2
trixat_nog	neg	-1
trycka_ned_i_skoskaften	neg	-2
tråka_ut	neg	-2
tråkig_känsla	neg	-2
tuffare_lockdown	neg	-2
tuffare_tider	neg	-2
tufft_nog	neg	-2
tumme_ner	neg	-2
<tummen_ner>	neg	-2
tummen_ner	neg	-2
<tummen_upp>	pos	2
tummen_upp	pos	2
tunga_experter	pos	2
tunga_hjärtan	neg	-2
tunga_institutioner	pos	2
tunga_läget	neg	-2
tunga_samtal	neg	-2
tunga_steg	neg	-2
tunga_stimulanspaket	pos	2
tunga_vintern	neg	-2
tung_belastning	neg	-2
tung_insikt	neg	-2
tung_kritik	neg	-3
tung_situation	neg	-2
tungt_ansvar	neg	-2
tungt_arbete	neg	-2
tungt_belastade	neg	-2
tungt_belastad	neg	-2
tungt_besked	neg	-2
tungt_beslut	neg	-2
tungt_hjärta	neg	-2
tungt_jobb	neg	-2
tungt_lass	neg	-2
tungt_läge	neg	-2
tungt_meriterade	pos	2
tung_uppgift	neg	-2
tur_i_oturen	pos	1
tveksamt_nog	neg	-2
tvinga_fram	neg	-2
två_ansikten	neg	-2
tvärlågt_förtroende	neg	-2
tvätta_av	pos	2
tvätta_bort	pos	2
tvättade_bort	pos	2
tvätta_pengar	neg	-2
tvättar_pengar	neg	-2
tycka_om	pos	2
tydliga_besked	pos	2
tydlig_diskriminering	neg	-2
tydlig_evidens	pos	2
tydlig_förbättring	pos	2
tydlig_risk	neg	-2
tydlig_skillnad	pos	2
tydligt_fokus	pos	2
tysta_ner	neg	-2
tyvärr_nog	neg	-2
tål_inte	neg	-2
täckt_med_socker	neg	-2
tänka_om	pos	2
tänka_själva	pos	2
tänker_om	pos	2
täppa_till	neg	-2
ultrahård_linje	neg	-2
undandra_sig	neg	-2
under_all_kritik	neg	-2
under_isen	neg	-2
underkasta_sig	neg	-2
underliggande_hälsoproblem	neg	-2
underliggande_sjukdomar	neg	-2
underliggande_sjukdom	neg	-2
undermedvetet_påverkat	neg	-2
unna_sig	neg	-2
upphöjande_av_forskare_till_skyarna	pos	2
uppseendeväckande_rapport	neg	-1
ur_balans	neg	-2
ur_funktionen	neg	-2
ur_funktion	neg	-2
ur_gängorna	neg	-2
ur_lag	neg	-2
ur_spel	neg	-2
utan_allvarliga_biverkningar	pos	2
utan_allvarliga_effekter	pos	2
utan_allvarliga_problem	pos	2
utan_anmärkning	pos	2
utan_feber	pos	2
utan_framgång	neg	-2
utan_hjälp	neg	-2
utan_hänsyn	neg	-2
utan_inkomst	neg	-2
utan_intresse	neg	-2
utan_jobb	neg	-2
utan_komplikationer	pos	2
utan_känslor	neg	-2
utan_läkarvård	neg	-2
utan_mål	neg	-2
utan_problem	pos	2
utan_restriktioner	pos	2
utan_risk	pos	2
utan_rädsla	pos	2
utan_skam	pos	1
utan_skydd	neg	-2
utan_stöd	neg	-2
utan_symptom	pos	2
utan_symtom	pos	2
utan_tillstånd	neg	-2
utan_tvekan	pos	2
utan_tvivel	pos	2
utan_urskillning	neg	-2
utan_vinstintresse	pos	2
utan_vård	neg	-2
utan_vänner	neg	-2
ute_och_cyklar	neg	-2
ute_o_cyklar	neg	-2
ute_på_hal_is	neg	-2
ute_å_cyklar	neg	-2
utkräva_hämnd	neg	-2
utmärker_sig	pos	2
utom_sig	neg	-2
utrota_corona	pos	2
utrota_covid-19	pos	2
utrotade_sjukdomar	pos	2
utrotade_smittan	pos	2
utrotar_corona	pos	2
utrotar_covid-19	pos	2
utrotar_sjukdomar	pos	2
utrotar_sjukdomen	pos	2
utrotar_smittan	pos	2
utrotar_viruset	pos	2
utrota_sjukdomar	pos	2
utrota_sjukdomen	pos	2
utrota_smittan	pos	2
utrotat_sjukdomar	pos	2
utrotat_smittan	pos	2
utrota_viruset	pos	2
utvecklar_sig	pos	2
utveckla_sig	pos	2
utöver_det_vanliga	pos	2
vad_fan	neg	-2
vad_fasiken	neg	-1
vad_obehagligt	neg	-2
va_fan	neg	-2
vaknat_till	pos	1
vanlig_biverkning	neg	-1
vara_med	pos	2
varit_utom_sig	neg	-2
varma_kakor	pos	2
varm_tårta	pos	2
varvar_upp	pos	2
varva_upp	pos	2
waste_of_life	neg	-2
vatten_ner	neg	-2
verklig_kris	neg	-2
vete_fan	neg	-1
vetenskaplig_källa	pos	2
vettig_källa	pos	2
vid_liv	pos	2
vifta_på_svansen	pos	2
viftar_på_svansen	pos	2
vika_ner_sig	neg	-2
viker_ner_sig	neg	-2
vila_i_frid	neg	-2
vilja_sig	pos	2
vilseledande_information	neg	-2
vinna_segerpalmen	pos	2
visar_upp	pos	2
visa_upp	pos	2
viss_trygghet	pos	2
vrida_sig	neg	-2
vräka_sig	pos	2
vräker_sig	pos	2
våldsamt_slag	neg	-2
vädigt_allvarstyngt	neg	-2
väl_ansedd	pos	2
väl_ansluten	pos	2
väl_avrundad	pos	2
väl_bakgrundsbelyst	pos	2
väl_dokumenterad	neg	-2
väl_fungerande	pos	2
väl_förberedda	pos	2
väl_förberedd	pos	2
väl_förberett	pos	2
väl_mottaget	pos	2
väl_positionerade	pos	2
väl_positionerad	pos	2
väl_rustade	pos	2
vältra_sig	neg	-2
väl_unt	pos	2
väl_uppfödda	pos	2
vända_till_det_bättre	pos	2
vänder_till_det_bättre	pos	2
vänliga_hälsningar	pos	2
vänta_fortfarande	neg	-1
vänta_i_evigheter	neg	-1
vänta_på_hjälp	neg	-1
väntar_fortfarande	neg	-1
väntar_i_evigheter	neg	-1
väntar_på_hjälp	neg	-1
värka_ut	pos	2
värker_ut	pos	2
värnar_om	pos	2
värst_drabbade	neg	-2
värst_drabbad	neg	-2
ytterligare_förbättra	pos	2
ytterligare_restriktioner	neg	-2
yttre_hot	neg	-2
åka_dit	pos	2
åkte_dit	pos	2
ångrade_sig	pos	2
ångrar_sig	pos	2
ångra_sig	pos	2
ångrat_sig	pos	2
återhämtade_sig	pos	2
återhämtar_sig	pos	2
återhämta_sig	pos	2
återhämtat_sig	pos	2
åt_h-vete	neg	-2
ägnar_sig	pos	2
ägna_sig	pos	2
älskar_sig	pos	2
ökade_dödligheten	neg	-2
ökad_risk	neg	-2
ökat_våld	neg	-2
ökat_välbefinnande	pos	2
öppen_krigsförklaring	neg	-2
över_min_döda_kropp	neg	-2
